10-13.wikia.com	XF_10-13 Wiki	en
11eyes.wikia.com	11eyes Wiki	en
1919.wikia.com	1919 Wiki	en
24.wikia.com	Wiki 24	en
30rock.wikia.com	30 Rock Wiki	en
39clues.wikia.com	The 39 Clues Wiki	en
4400.wikia.com	The 4400 Wiki	en
5an.wikia.com	5AN	de
6teen.wikia.com	6teen Wiki	en
8bittheater.wikia.com	Sardapedia	en
90210.wikia.com	90210 Wiki	en
9dragons.wikia.com	9dragons Wiki	en
Cityofheroes.wikia.com	City of Heroes Wiki	en
Dcanimated.wikia.com	DC Animated Universe	en
Diablo.wikia.com	Diablo Wiki	en
Dinocrisis.wikia.com	Dino Crisis Wiki	en
Disney.wikia.com	Disney Wiki	en
Dune.wikia.com	Dune	en
Finance.wikia.com	Finance	en
Gargoyles.wikia.com	Grimorum	en
Hamumu.wikia.com	Hamumu Wiki	en
LegacyOfKain.wikia.com	Legacy of Kain Wiki	en
LittleBigPlanet.wikia.com	LittleBigPlanet Wiki	en
Mightyboosh.wikia.com	The Mighty Boosh Wiki	en
MusicBlog.wikia.com	MusicBlogWiki	en
Pvx.wikia.com	PvXwiki	en
Ricorodriguez.wikia.com	Jama Rico	en
Talesofpirates.wikia.com	Tales Of Pirates Wiki	en
ThoriumBrotherhood.wikia.com	Thorium Brotherhood Wiki	en
abc-daytime.wikia.com	ABC Daytime Wiki	en
abklebensmittel.wikia.com	ABKLebensmittel	de
absurdopedia.wikia.com	Абсурдопедия	ru
academicjobs.wikia.com	Academic Jobs Wiki	en
acecombat.wikia.com	Acepedia	en
achievement.wikia.com	Achievement Wiki	en
achievements.wikia.com	Cheevo Archive Wiki	en
achopz.wikia.com	Zenkora Wiki	en
addamsfamily.wikia.com	Addams Family Wiki	en
address.answers.wikia.com	Wikianswers Addresses	en
admintools.wikia.com	Admin Tools Wiki	en
advancing-evolution.wikia.com	Advancing Evolution Wiki	en
adventurequestworlds.wikia.com	AdventureQuest Worlds Wiki	en
aforathlete.wikia.com	A for Athlete	en
agarest.wikia.com	Agarest Wiki	en
agt.wikia.com	America's Got Talent Wiki	en
ahw.wikia.com	AHW Wiki	en
ajayproductions.wikia.com	Ajay Productions Wiki	en
alarmfuercobra11.wikia.com	Alarm für Cobra 11 Wiki	de
albuspotter.wikia.com	Albus Potter Wiki	en
alcatraz.wikia.com	Alcatraz Wiki	en
alicesoft.wikia.com	AliceSoftWiki	en
aliens.wikia.com	Alien Species	en
allods.wikia.com	Allods Wiki	en
allstar.wikia.com	All*Starpedia	en
aloneinthedark.wikia.com	Alone in the Dark Wiki	en
alteil.wikia.com	Alteil Wiki	en
althistory.wikia.com	Alternative History	en
alvin.wikia.com	Alvin and the Chipmunks Wiki	en
alvinfanon.wikia.com	Chipmunk Fanon Wiki	en
alykes.wikia.com	ΑΛΥΚΕΣ ΛΕΥΚΙΜΜΗΣ	el
amalgam.wikia.com	Amalgam Database	en
amazingrace.wikia.com	The Amazing Race Wiki	en
americanfootball.wikia.com	American Football Wiki	en
americangirl.wikia.com	American Girl Wiki	en
americanidol.wikia.com	American Idol Wiki	en
ameriv.wikia.com	Ameriv	de
aml.wikia.com	AML Wiki	en
amusementride.wikia.com	Amusement ride Wiki	en
analytical.wikia.com	Analytical Wiki	en
anarchyonline.wikia.com	Anarchy Online Knowledge Base	en
anathem.wikia.com	Anathem Wiki	en
ancient-life.wikia.com	Time Traveller's Guide to Ancient Life	en
ancientegypt.wikia.com	Ancient Egypt Wiki	en
andalu.wikia.com	Andalu	es
animalcollective.wikia.com	Animal Collective	en
animalcrossing.wikia.com	Animal Crossing Wiki	en
animalkaiser.wikia.com	Animal Kaiser Wiki	en
animated.wikia.com	Animated Wiki	en
animatedvillains.wikia.com	Animated Villains Wiki	en
anime.answers.wikia.com	Wikianswers Anime	en
animebaths.wikia.com	Anime Bath Scene Wiki	en
animefanon.wikia.com	Anime Fanon	en
animemagics.wikia.com	Jutsu Wiki	en
anitablake.wikia.com	Anita Blake Wiki	en
annex.wikia.com	Annex	en
annoyingorange.wikia.com	Annoying Orange Wiki	en
answers.wikia.com	Wikianswers	en
aoc.wikia.com	AoCWiki	en
aoin.wikia.com	Alliance of Independent Nations Wiki	en
aos.wikia.com	An Oblivious Wiki	en
apb.wikia.com	All Points Bulletin Wiki	en
apicultura.wikia.com	Apicultura Wiki	es
apocalypserp.wikia.com	Apocalypse Wiki	en
apple.wikia.com	Apple Wiki	en
applesparkles.wikia.com	Frozen Apples	en
aqua-teen-hunger-force.wikia.com	ATHF Wiki	en
aquaman.wikia.com	Aquaman Wiki	en
aqworlds.wikia.com	AdventureQuest Worlds Wiki	en
ar.answers.wikia.com	Wikianswers Arabic	ar
ar.shamanking.wikia.com	Arabic Shaman king Wiki	ar
ar.stargate.wikia.com	ستارغيت ويكي	ar
arcanelorebook.wikia.com	The Arcane Book of Lore Wiki	en
archiesonic.wikia.com	Mobius Encyclopaedia	en
ardeaminigo.wikia.com	ArdeaMinigo	de
arelith.wikia.com	Arelith Wiki	en
armchairgm.wikia.com	ArmchairGM Wiki	en
armoredcore.wikia.com	Armored Core Wiki	en
arsmagica.wikia.com	Ars Magica Wiki	en
arthoria.wikia.com	Arthoria	de
arthur.wikia.com	Arthur Wiki	en
arthur-ransome.wikia.com	Arthur Ransome Wiki	en
artonelico.wikia.com	EXA_PICO Universe Wiki	en
artywiki.wikia.com	Artemis Fowl Wiki	de
aruarose.wikia.com	AruaWIKIA	en
aselia.wikia.com	Aselia	en
asheron.wikia.com	Asheron's Call Community Wiki	en
asian.wikia.com	EverythingAsian	en
associationfootball.wikia.com	AssociationFootball Wiki	en
asthebellrings.wikia.com	As the Bell Rings Wiki	en
astroboy.wikia.com	Astro Boy Wiki	en
atelierseries.wikia.com	Atelier Wiki	en
atkvege.wikia.com	Community Central	en
atlantica.wikia.com	Atlantica Wiki	en
atlus.wikia.com	Atlus Wiki	en
austrianeconomics.wikia.com	Austrian Economics Wiki	en
auto.answers.wikia.com	Everything Auto Answers	en
automobile.wikia.com	Autopedia	en
avatar.wikia.com	Avatar Wiki	en
avp.wikia.com	Xenopedia	en
awatar.wikia.com	Awatar Wiki	pl
awesomeepicgameing.wikia.com	Awesome epic gaming Wiki	en
axisandallies.wikia.com	Axis & Allies Wiki	en
ayuda.wikia.com	Comunidad Central	es
azusanity.wikia.com	The AzuSanity Wiki	en
babylon5.wikia.com	The Babylon Project	en
backofthenet.wikia.com	Back of the Net Wiki	en
backtothefuture.wikia.com	Futurepedia	en
backyardsports.wikia.com	Backyard Sports Wiki	en
bakugan.wikia.com	Bakugan Wiki	en
bakuganfanfic.wikia.com	Bakugan Fan-fiction Wiki	en
bakuganfanon.wikia.com	Bakugan Fanon Wiki	en
bakuman.wikia.com	Bakuman Wiki	en
banjokazooie.wikia.com	Banjo-Kazooie Wiki	en
banthapedia.wikia.com	The Non-Canon Star Wars Wiki	en
bardslibrary.wikia.com	RK Guild of Bards Library	en
bargos.wikia.com	Wichibargos	en
barney.wikia.com	Barney Wiki	en
barnyard.wikia.com	WikiBarn	en
bartimaeus.wikia.com	The Bartimaeus Trilogy	en
baseball.wikia.com	Baseball Wiki	en
baseballcards.wikia.com	Baseball Cards Wiki	en
basketball.wikia.com	Basketball Wiki	en
batenkaitos.wikia.com	Baten Kaitos Wiki	en
batman.wikia.com	Batman Wiki	en
batmanfanon.wikia.com	Batman Fanon Wiki	en
battalionwars.wikia.com	Battalion Wars Wiki	en
battleangel.wikia.com	Battle Angel Alita Wiki	en
battlefieldheroes.wikia.com	Battlefield Heroes Wiki	en
battlenetwork.wikia.com	Battle Network Wiki	en
battletechfanon.wikia.com	BattleTech Fanon Wiki	en
bbdamanbakugaiden.wikia.com	Bomberman B-Daman Bakugaiden Wiki	en
beano.wikia.com	Beano-pedia	en
beantowntoys.wikia.com	Beantown Toys Wiki	en
beingerica.wikia.com	Being Erica Wiki	en
beinghuman.wikia.com	Being Human Wiki	en
bemani.wikia.com	Konami Music Video Game Wiki	en
ben10.wikia.com	Ben 10 Wiki	en
ben10fanfiction.wikia.com	Ben 10 Fan Fiction Wiki	en
ben10fanon.wikia.com	Fanontrix	en
ben10verse.wikia.com	Ben 10 Universe Wiki	en
berenstainbears.wikia.com	Berenstain Bears Wiki	en
berserk.wikia.com	Berserk Wiki	en
beta-fleet.wikia.com	Beta-Fleet	en
bettyboop.wikia.com	BETTY BOOP Wiki	en
beyond-good-and-evil.wikia.com	IRIS Network - The Beyond Good and Evil Wiki	en
beyond-the-veil.wikia.com	Beyond the Veil wiki	en
bg.starwars.wikia.com	Star Wars	bg
bigbangtheory.wikia.com	The Big Bang Theory Wiki	en
bigbrother.wikia.com	Big Brother Wiki	en
bigtimerush.wikia.com	Big Time Rush Wiki	en
bigwindup.wikia.com	Big Windup! Wiki	en
bikeparts.wikia.com	BikeParts Wiki	en
bikinirangerscelebrity.wikia.com	Bikini Rangers Celebrity Wiki	en
bing.wikia.com	Bing Wiki	en
binweevils.wikia.com	Bin Weevils Wiki	en
bionic.wikia.com	The Bionic Wiki	en
bionicle.wikia.com	The BIONICLE Wiki	en
bioniclereviews.wikia.com	Bionicle Reviews Wiki	en
bioshock.wikia.com	BioShock Wiki	en
bjd.wikia.com	Ball-Jointed Doll Wiki	en
blackjewels.wikia.com	The Black Jewels Wiki	en
blacktales.wikia.com	Blacktales	de
bleach.wikia.com	Bleach Wiki	en
bloggerhacks.wikia.com	Bloggerhacks Wiki	en
blur.wikia.com	Blur Wiki	en
board8.wikia.com	Board 8 Wiki	en
boardgamemanuals.wikia.com	Board game manuals Wiki	en
bonanza.wikia.com	Bonanza Wiki	en
boneville.wikia.com	Bone Wiki	en
boondocks.wikia.com	The Boondocks Wiki	en
borderlands.wikia.com	Borderlands Wiki	en
boston-celtics.wikia.com	Boston Celtics Wiki	en
bottest.wikia.com	Bot Test Wiki	en
boymeetsworld.wikia.com	Boy Meets Wiki	en
bradywwe.wikia.com	Brady Wiki	en
brightshadow.wikia.com	Bright Shadow Wiki	en
brink.wikia.com	Brink Wiki	en
bristolrovers.wikia.com	Gasopedia - Bristol Rovers Wiki	en
britishwildlifeandnature.wikia.com	British Wildlife Wiki	en
broadcasting.wikia.com	Radio-TV Broadcast History	en
budowle.wikia.com	Budowle i wieżowce	pl
buffy.wikia.com	Buffyverse Wiki	en
buffymud.wikia.com	BuffyMUD Wiki	en
bugle.wikia.com	The Bugle Wiki	en
bully.wikia.com	Bully Wiki	en
bungie.wikia.com	Bungiepedia	en
burnnotice.wikia.com	Burn Wiki	en
burnout.wikia.com	Burnout Wiki	en
bushytree.wikia.com	IEEE Bushy Tree	en
business.wikia.com	Wikibiz	en
buzzoutloud.wikia.com	Buzz Out Loud Wiki	en
bzpcomics.wikia.com	BZPower Comics Wiki	en
bzpepics.wikia.com	BZP Epics Wiki	en
bzpower.wikia.com	BZPower Roleplaying Wiki	en
ca.llofriu.wikia.com	Llofriu Wiki	ca
ca.pokemon.wikia.com	Pokepèdia	ca
ca.svaters.wikia.com	Sva Wiki	ca
cabal.wikia.com	Cabal Online Wiki	en
cafeworld.wikia.com	Cafe World Wiki	en
calendars.wikia.com	Calendar Wiki	en
calgary.wikia.com	Calgary Wiki	en
callofduty.wikia.com	Call of Duty Wiki	en
calvinandhobbes.wikia.com	The Calvin and Hobbes Wiki	en
camerapedia.wikia.com	Camerapedia	en
campaigns.wikia.com	Campaigns Wikia	en
camphalfblood.wikia.com	Riordan Wiki	en
camplazlo.wikia.com	Camp Lazlo Wiki	en
canada.wikia.com	Canada Wiki	en
canadaswonderland.wikia.com	Canada's Wonderland Wiki	en
canavansbooks.wikia.com	Canavan's Books Wiki	en
cannabis.wikia.com	WeedWiki	en
capoeira.wikia.com	Capoeira Wiki	fr
captainn.wikia.com	Captain N Wiki	en
captaintsubasa.wikia.com	Captain Tsubasa Wiki	en
car-repair.wikia.com	Car Repair Wiki	en
carebears.wikia.com	Care Bear Wiki	en
carmageddon.wikia.com	Carmageddon Wiki	en
carnivores.wikia.com	Carnivores Wiki	en
cartoonnetwork.wikia.com	The Cartoon Network Wiki	en
cartoons.wikia.com	Wikicartoon	en
caseclosed.wikia.com	Detective Conan Wiki	en
castle.wikia.com	Castle Wiki	en
castleage.wikia.com	Castle Age Wiki	en
castlecrashers.wikia.com	Castle Crashers Wiki	en
castlevania.wikia.com	Castlevania Wiki	en
cats.wikia.com	Cats Wiki	en
catsofclans.wikia.com	Cats of the Clans Wiki	en
catsvillecomics.wikia.com	Catsville Wiki	en
caucasus.wikia.com	Caucasus Wiki	en
cavaleirosandantes.wikia.com	Cavalariapédia	pt-br
caw.wikia.com	CAW Wrestling Wiki	en
cbbc.wikia.com	CBBC	en
ccs.wikia.com	Cardcaptor Sakura Wiki	en
celebrity.wikia.com	Celebrity Wiki	en
celestial-refresh.wikia.com	Celestial Refresh Wiki	en
ceramica.wikia.com	Cerámica Wiki	es
cercamon.wikia.com	Cercamon	fr
change.wikia.com	Change Wiki	en
channel101.wikia.com	Channel 101 Wiki	en
charliesangels.wikia.com	Charlie's Angels Wiki	en
charmed.wikia.com	Charmed	en
charmed-theseerspool.wikia.com	Charmedverse Wiki	en
chataboutheroesrp.wikia.com	HeroesRP Wiki	en
cherryhill.wikia.com	Cherry Hill Wiki	en
chess.wikia.com	WikiChess	en
chibirobo.wikia.com	Chibi Robo Wiki	en
chicagobynight.wikia.com	Chicago By Night Wiki	en
childlit.wikia.com	Children's Literature Wiki	en
childrensbooks.wikia.com	Children's Books Wiki	en
chipschallenge.wikia.com	Chip's Challenge Wiki	en
choroq.wikia.com	Choro Q Wiki	en
chotbul.wikia.com	촛불 집회 위키	ko
chowder.wikia.com	Chowder Fan Club	en
christianity.wikia.com	Christianity Knowledge Base	en
christianmusic.wikia.com	Christian Music	en
chrono.wikia.com	Chrono Wiki	en
chuggington.wikia.com	Chuggington Wiki	en
chuutranslations.wikia.com	ChuuTranslations Wiki	en
cimmeria-aoc.wikia.com	Cimmeria AoC RP Server Wiki	en
cities.wikia.com	Cities Wikia	en
citiesxl.wikia.com	Cities XL Wiki	en
cityofeternals.wikia.com	City of Eternals Wiki	en
clash-of-the-titans.wikia.com	Clash of the Titans Wiki	en
clayfighter.wikia.com	ClayFighter Wiki	en
claymore.wikia.com	Claymore Wiki	en
cleveland.wikia.com	The Cleveland Show Wiki	en
clonewars.wikia.com	The Clone Wars	en
closinglogos.wikia.com	Closing Logos Wiki	en
cloudnine.wikia.com	Cloud Nine Wiki	en
club-cricket.wikia.com	Club Cricket Wiki	en
clubpenguin.wikia.com	Club Penguin Wiki	en
clubpenguinarmy.wikia.com	Club Penguin Army Wiki	en
clubpenguinfanon.wikia.com	Club Penguin Fan Universe	en
cn.uncyclopedia.wikia.com	伪基百科	zh
cnben10.wikia.com	Ben 10 Wiki	en
cnc.wikia.com	Command and Conquer Wiki	en
cocktails.wikia.com	Cocktails Wiki	en
codegeass.wikia.com	Code Geass Wiki	en
coincollecting.wikia.com	Coin Collecting Wiki	en
coldcase.wikia.com	Cold Case Wiki	en
color.wikia.com	Color Sorting	en
combatarms.wikia.com	CAWiki	en
comics.wikia.com	Comic Book Series	en
communaute.wikia.com	Centre des communautés	fr
community.wikia.com	Community Central	en
community-sitcom.wikia.com	Community Wiki	en
como-hacer.wikia.com	Cómo Hacer Wiki	es
computer.wikia.com	Computer Wiki	en
computersecurity.wikia.com	Computer Security Wiki	en
computervision.wikia.com	Computer vision	en
concertogate.wikia.com	Concerto Gate Wiki	en
concord.wikia.com	Concordances and Characters	en
conduit.wikia.com	The Conduit Wiki	en
confan.wikia.com	Constructed Fantasy Worlds	en
conhorror.wikia.com	Constructed Horror Wiki	en
conlang.wikia.com	Conlang	en
conmyth.wikia.com	Constructed Mythology	en
conquests.wikia.com	Conquests Omnipedia	en
conservapedia.wikia.com	Conservapedia Wiki	en
continuingstargate.wikia.com	Continuing Stargate Wiki	en
conworld.wikia.com	Constructed Worlds Wiki	en
coop.wikia.com	Cooperatives Wiki	en
coronationstreet.wikia.com	Coronation Street Wiki	en
cottitans.wikia.com	Class of the titans Wiki	en
crashdown.wikia.com	Roswell Wiki	en
crazybobs.wikia.com	CrazyBob's Cops and Robbers Wiki	en
creativesci-fi.wikia.com	Creative Sci-Fi Wiki	en
creativity.wikia.com	Creativity Wiki	en
creature.wikia.com	Creatures Wiki	en
creatures.wikia.com	Creatures Wikia	en
crepusculo.wikia.com	Crepúsculo Wiki	es
criminalminds.wikia.com	Criminal Minds Wiki	en
crimsonskies.wikia.com	Crimson Skies Wiki	en
croc.wikia.com	Croc: Wiki of the Gobbos	en
crossover.wikia.com	Crossover Wiki	en
crucigramas.wikia.com	Geniogramistas Wiki	es
cs.farmville.wikia.com	Farmville Wiki	cs
cs.forbiddensaga.wikia.com	Forbidden Saga Wiki	cs
cs.starwars.wikia.com	Czech Star Wars Wiki	cs
custombionicle.wikia.com	Custom BIONICLE Wiki	en
cutemario.wikia.com	Cute Mario Bros. Wiki	en
cwa.wikia.com	CWA Wiki	en
cyberchase.wikia.com	Cyberchase Wiki	en
cybernations.wikia.com	Cyber Nations Wiki	en
d20npcs.wikia.com	d20 NPC Wiki	en
d6holocron.wikia.com	Community Central	en
da.carlsberg.wikia.com	Carlsberg Wiki	da
da.danskefilm.wikia.com	Dansk Film Database Wiki	da
da.harrypotter.wikia.com	Harry Potter Wiki	da
da.lostpedia.wikia.com	Lostpedia	da
da.runescape.wikia.com	RuneScape Wiki	da
da.tvkanal.wikia.com	TV Kanal Wiki	da
da.tydnanyd.wikia.com	Things You Didn't Know.. And NO, you didn't! Wiki	da
danball.wikia.com	Dan-Ball Wiki	en
darelth.wikia.com	Darelth Wiki	en
darkagesofcybertron.wikia.com	Dark Ages of Cybertron Wiki	en
darkangel.wikia.com	Dark Angel Wiki	en
darkcrystal.wikia.com	The Dark Crystal Wiki	en
darkmoonfaire.wikia.com	Darkmoon Faire Wiki	en
darkness.wikia.com	Roqoo Depot RPG Wiki	en
darkshadows.wikia.com	The Dark Shadows Wiki	en
darksiders.wikia.com	Darksiders Wiki	en
darth.wikia.com	Simple Darthipedia	en
dawnofwar2.wikia.com	Dawn of War II Wiki	en
dawntide.wikia.com	Dawntide Wiki	en
dayd.wikia.com	DAYDverse Wiki	en
dcmovies.wikia.com	DC Movies Wiki	en
dcuniverseonline.wikia.com	DC Universe Online Wiki	en
de.7schwaben.wikia.com	7Schwaben	de
de.anarchyonline.wikia.com	Anarchy Online	de
de.anime.wikia.com	Animanga Wiki	de
de.aoc.wikia.com	Age of Conan Wiki	de
de.avatar.wikia.com	Avatar-Wiki	de
de.ben10.wikia.com	Ben 10 Wiki	de
de.beyblade.wikia.com	Beyblade Wiki	de
de.bleach.wikia.com	BleachWiki	de
de.borderlands.wikia.com	Borderlands Wiki	de
de.call-of-duty.wikia.com	Call of Duty Wiki	de
de.chh.wikia.com	Anima: Schlüssel Wiki	de
de.custombionicle.wikia.com	Wiki-Nui Fanfiction	de
de.darkorbit.wikia.com	Dark Orbit Wiki	de
de.dashausanubis.wikia.com	Das Haus Anubis Wiki	de
de.ddr2.wikia.com	DDR	de
de.desperatehousewives.wikia.com	Desperate Housewives Wiki	de
de.detailhandel.wikia.com	Detailhandel	de
de.detektivconan.wikia.com	Detektiv Conan Wiki	de
de.digimon.wikia.com	DigiPedia	de
de.dragonball.wikia.com	Gokupedia	de
de.dtm.wikia.com	DTM Wiki	de
de.elderscrolls.wikia.com	Elder Scrolls Wiki	de
de.elfen-und-zwerge.wikia.com	Die Elfen & Die Zwerge Wiki	de
de.eragon.wikia.com	Eragon	de
de.eropedia.wikia.com	Community Central	en
de.fable.wikia.com	Das Fable Wiki	de
de.faerun.wikia.com	Faerûnpedia	de
de.fairytail.wikia.com	Fairy Tail	de
de.familyguy.wikia.com	Family Guy Wiki	de
de.farmville.wikia.com	FarmVille Wiki	de
de.finalfantasy.wikia.com	Final Fantasy Almanach	de
de.fireemblem.wikia.com	Fire Emblem Wiki	de
de.flyff.wikia.com	Flyff-Wiki	de
de.freelancer.wikia.com	Freelancer-Wiki	de
de.freigonfalonierat.wikia.com	Freigonfalonierat Wiki	de
de.funorb.wikia.com	FunOrb Wiki	de
de.gaming.wikia.com	Wikia Gaming	de
de.godzilla.wikia.com	Godzilla-Wiki	de
de.goldensun.wikia.com	Golden Sun Wiki	de
de.green.wikia.com	Umwelt-Wiki	de
de.gta.wikia.com	GTA Wiki	de
de.halo.wikia.com	Halopedia	de
de.harry-potter.wikia.com	Harry Potter Wiki	de
de.harrypotter.wikia.com	Harry-Potter-Lexikon	de
de.harvestmoon.wikia.com	Harvest-Wiki	de
de.helmstedt.wikia.com	helmstedt	de
de.hitmanreborn.wikia.com	HitmanReborn-Wiki	de
de.hochelfen.wikia.com	Hochelfen	de
de.icarly.wikia.com	iCarly-Pedia	de
de.ikariam.wikia.com	Ikariam- Wiki	de
de.inuyasha.wikia.com	InuYasha Wiki	de
de.james-camerons-avatar.wikia.com	Avatar Wiki	de
de.jamesbond.wikia.com	BondWiki	de
de.jordriken.wikia.com	Jordriken Wiki	de
de.jurassicpark.wikia.com	JP-Wiki	de
de.kabarett.wikia.com	Kabarett Wiki	de
de.kingdomhearts.wikia.com	Kingdom hearts Wiki	de
de.kirby.wikia.com	Kirby-Wiki	de
de.lawandorder.wikia.com	Law & Order Wiki	de
de.layton.wikia.com	Professor Layton Wiki	de
de.lego.wikia.com	Legopedia	de
de.legostarwars.wikia.com	Lego Star Wars-Wiki	de
de.lostpedia.wikia.com	Lostpedia	de
de.lotr.wikia.com	Der Herr der Ringe Wiki	de
de.luzipedia.wikia.com	Luzide Wahrheiten Wiki	de
de.madagascar.wikia.com	Madagascar-Wiki	de
de.mahousenseinegima.wikia.com	Mahou Sensei Negima Wiki	de
de.mario.wikia.com	MarioWiki	de
de.masseffect.wikia.com	Mass Effect Wiki	de
de.metalgear.wikia.com	Metal Gear Wiki	de
de.metroid.wikia.com	Wikitroid	de
de.mini.wikia.com	Mini-Wikia	de
de.monsterhunter.wikia.com	Monster Hunter Wiki	de
de.monsterrancher.wikia.com	Monster Rancher Wiki	de
de.motorsport.wikia.com	MotorSport	de
de.narnia.wikia.com	Narnia-Wiki	de
de.naruto.wikia.com	Narutopedia	de
de.needforspeed.wikia.com	Need for Speed Wiki	de
de.newmt2.wikia.com	Newmt2 Wiki	de
de.nickelodeon.wikia.com	Nickelodeon Wiki	de
de.nintendo.wikia.com	Nintendo-Wiki	de
de.nsc.wikia.com	NSC-Wiki	de
de.onepiece.wikia.com	OnePiecePedia	de
de.onetreehill.wikia.com	One Tree Hill Wiki	de
de.papermario.wikia.com	Paper Mario Wiki	de
de.paraworld.wikia.com	ParaWorld Wiki	de
de.pokemon.wikia.com	Pokémon Wiki	de
de.prowrestling.wikia.com	Pro-Wrestling	de
de.prwiki.wikia.com	PR Wiki	de
de.reddead.wikia.com	Red Dead Redemption Wiki	de
de.rom.wikia.com	Runes of Magic Wiki	de
de.runescape.wikia.com	RuneScape Wiki	de
de.sailormoon.wikia.com	SailorMoon	de
de.saintsrow.wikia.com	Saints Row Wiki	de
de.scrubs.wikia.com	Scrubs-Wiki	de
de.sims.wikia.com	Sims-Wiki	de
de.sliders.wikia.com	Sliders Wiki	de
de.smallville.wikia.com	Smallville Wiki	de
de.soaps.wikia.com	Soaps-Wiki	de
de.software.wikia.com	Software-Wiki	de
de.spellbinder.wikia.com	Spellbinder-Wiki	de
de.spinn.wikia.com	Spinn Wiki	de
de.stargate.wikia.com	Community Central	en
de.starwars.wikia.com	Jedipedia	de
de.stexpanded.wikia.com	Star Trek Fanfiction	de
de.stolzenau.wikia.com	Stolzenau Wiki	de
de.suikoden.wikia.com	Suikoden-Wiki	de
de.supernatural.wikia.com	Supernatural Wiki	de
de.swfanon.wikia.com	Star Wars Fanfiction	de
de.sww.wikia.com	Scion Worldwide Wiki	de
de.tabularasa.wikia.com	Tabula Rasa Wiki	de
de.tauchplaetze.wikia.com	tauchplaetze	de
de.techno.wikia.com	Techno Wiki	de
de.tibia.wikia.com	Tibia Wiki	de
de.transformers.wikia.com	Transformers Wiki	de
de.trekspace.wikia.com	Trekspace Wiki	de
de.tsubasa.wikia.com	Captain Tsubasa Wiki	de
de.twilight.wikia.com	Twilight Serie Wiki	de
de.twoandahalfmen.wikia.com	Two and a half men Wiki	de
de.urban-rivals.wikia.com	Urban Rivals Wiki	de
de.valve.wikia.com	Valve Wiki	de
de.vampirediaries.wikia.com	Vampire Diaries Wiki	de
de.volkslauf.wikia.com	Volkslauf Wiki	de
de.wakfu.wikia.com	Wakfu	de
de.whitewolf.wikia.com	White Wolf Wiki	de
de.winxclub.wikia.com	Winx Club Wiki	de
de.wow.wikia.com	WoWWiki	de
de.yugioh.wikia.com	Yu-Gi-Oh!	de
de.zelda.wikia.com	Zeldapedia	de
dead-rising.wikia.com	Dead Rising Wiki	en
deadfrontier.wikia.com	Dead Frontier Wiki	en
deadmanwonderland.wikia.com	Deadman Wonderland Wiki	en
deadrising.wikia.com	Dead Rising Wiki	en
debugunused.wikia.com	Debug Modes and Unused Stuff	en
decoderringtheatre.wikia.com	Decoder Rng Theatre wiki	en
defensieweb.wikia.com	Defensieweb wiki	nl
deloreantech.wikia.com	DeLorean Tech Wiki	en
delphi.wikia.com	Delphi Programming	en
deltoraquest.wikia.com	Deltora Quest Wiki	en
demigod.wikia.com	Demigod Wiki	en
demo.egs-mayhem.wikia.com	Egs Mayhem Wiki	en
deptfordmice.wikia.com	The Deptford Mice Wiki	en
dernierelune.wikia.com	Dernière Lune	fr
desencyclopedie.wikia.com	Désencyclopédie	fr
deseretalphabet.wikia.com	Deseret Alphabet Wiki	en
destinationtruth.wikia.com	Destination Truth Wiki	en
destroyallhumans.wikia.com	Destroy All Humans Wiki	en
detektivconan.wikia.com	Detektiv Conan Wiki	de
dethklok.wikia.com	The Metalocalypse Wiki	en
deusex.wikia.com	Deus Ex Wiki	en
dev.wikia.com	Wikia Developers Wiki	en
dexterslab.wikia.com	Dexter's Laboratory Wiki	en
dfairies.wikia.com	Disney Fairies Wiki	en
dgrayman.wikia.com	D.Gray-man Encyclopedia	en
diabetesindogs.wikia.com	Canine Diabetes Wiki	en
diary-of-a-wimpy-kid.wikia.com	Diary of a Wimpy Kid Wiki	en
diealdor.wikia.com	Die Aldor Wiki	de
diedreifragezeichen.wikia.com	Die drei Fragezeichen Wiki	de
digifanon.wikia.com	DigiFanon	en
digimon.wikia.com	DigimonWiki	en
digitalph33r.wikia.com	DigitalPh33rsons Adventures Wiki	en
dimensionscollide.wikia.com	Cubevice Wiki	en
dinerdash.wikia.com	Diner Dash Wiki	en
dino.wikia.com	Dinosaur Wiki	en
dinorey.wikia.com	La enciclopedia de Dino Rey	es
dinosaurking.wikia.com	Dinosaur King	en
disciples.wikia.com	The Disciples Wiki	en
discordia.wikia.com	Discordian Wiki	en
discworldmud.wikia.com	Discworld MUD Wiki	en
disneychannel.wikia.com	Disney Channel Wiki	en
disneyfanon.wikia.com	Disney Fanon Wiki	en
disneyparks.wikia.com	Disney Parks Wiki	en
disneyvillains.wikia.com	Wickedpedia	en
disneyxd.wikia.com	Disney XD Wiki	en
dissidia.wikia.com	Dissidia Wiki	en
dittotown.wikia.com	Ditto Town Wiki	en
divinity.wikia.com	Divinity Wiki	en
diy.wikia.com	DIY Culture	en
dnd4.wikia.com	D&D4 Wiki	en
dndta.wikia.com	Dungeons & Dragons Tiny Adventures	en
doblaje.wikia.com	Doblaje Wiki	es
docteurwho.wikia.com	Doctor Who Wiki	fr
doctor-who-collectors.wikia.com	Doctor Who Collectors Wiki	en
doctors.answers.wikia.com	Community Central	en
doctorwhoconcordance.wikia.com	Doctor Who Concordance Wiki	en
doctorwhointernetadventures.wikia.com	Doctor Who Internet Adventures Wiki	en
domo.wikia.com	Domo Wiki	en
donkeykong.wikia.com	Donkey Kong Wiki	en
doraemon.wikia.com	Doraemon Wiki	en
dothack.wikia.com	.hack//Wiki	en
dothq.wikia.com	Dragonica Online (THQ*Ice) Wiki	en
dovastv.wikia.com	Dövas TV wiki	sv
dragaera.wikia.com	Lyorn Records	en
dragcave.wikia.com	Dragon Cave Wiki	en
dragonage.wikia.com	Dragon Age Wiki	en
dragonball.wikia.com	Dragon Ball Wiki	en
dragonballaf.wikia.com	Dragonball AF-Wiki	de
dragonballaffanon.wikia.com	Dragon Ball AF Fanon Wiki	en
dragonballfanon.wikia.com	Dragonball Fanon Wiki	en
dragonballzbj.wikia.com	Dragonballz Wiki	en
dragonica.wikia.com	Dragonica Wiki	en
dragonicaonline.wikia.com	Dragonica Online Wiki	en
dragonquestrpg.wikia.com	Dragon Quest RPG	en
dragonrp.wikia.com	Roleplaying Adventures Wiki	en
drakensang.wikia.com	Drakensang Wiki	de
drakensang2.wikia.com	Am Fluss der Zeit Wiki	de
drawntolife.wikia.com	Drawn To Life Wiki	en
dreamlords.wikia.com	Dream Lords Wiki	en
dresdendolls.wikia.com	Dresden Dolls Wiki	en
duelmasters.wikia.com	Duel Masters Wiki	en
dungeons.wikia.com	Dungeons and Dragons Wiki	en
durarara.wikia.com	Durarara!! Wiki	en
dwexpanded.wikia.com	Doctor Who Expanded	en
earthbound.wikia.com	EarthBound Wiki	en
earthenring.wikia.com	Earthen Ring Wiki	en
earthfinalconflict.wikia.com	Earth: Final Conflict Wiki	en
earthquakes.wikia.com	Earthquakes Wiki	en
ec.wikia.com	Crossgen Comics Database Wiki	en
echoesofdarkness.wikia.com	Echoes Of Darkness Wiki	en
eddsworld.wikia.com	Eddsworld Wiki	en
edfanon.wikia.com	Ed, Edd n Eddy Fanon Wiki	en
edgeworld.wikia.com	Edgeworld Wiki	en
efteling.wikia.com	Efteling-Wiki	de
egalaktika.wikia.com	Enciklopedia Galaktika	hu
egipt.wikia.com	Egiptopedia	pl
eiga.wikia.com	Eiga Wiki	en
eincyclopedia.wikia.com	איןציקלופדיה	he
eisenbahn.wikia.com	EisenbahnWiki	de
ek.wikia.com	Epic Kingdoms Wiki	de
el.lineage2.wikia.com	Lineage 2 Wiki	el
el.science.wikia.com	Science Wiki	el
el.warhammeronline.wikia.com	Warhammer Online	el
el.wow.wikia.com	WoWWiki Ελληνικός οδηγός	el
elderscrolls.wikia.com	Elder Scrolls	en
elegante.wikia.com	MS Elegante Wiki	en
elfen-lied.wikia.com	Elfen Lied Wiki	en
elfquest.wikia.com	Elfquest Wiki	en
elgoonishshive.wikia.com	Shiveapedia	en
eliminatepro.wikia.com	Eliminate Pro Wiki	en
elona.wikia.com	Elona Wiki	en
eltigre.wikia.com	El Tigre Wiki	en
emberverse.wikia.com	Emberverse Wiki	en
empeorsneworld.wikia.com	Emperor's New Wiki	en
endlessocean.wikia.com	Endless Ocean Wiki	en
engineering.wikia.com	Engineering	en
enreas.wikia.com	Enreas	es
entertainment.wikia.com	Entertainment Wiki	en
entourage.wikia.com	Entourage Wiki	en
entrancewayrp.wikia.com	Entranceway Roleplay Wiki	en
epicbattlefantasy.wikia.com	Epic Battle Fantasy Wiki	en
ericflint.wikia.com	Eric Flint Wiki	en
es.aceattorney.wikia.com	Ace Attorney Wiki	es
es.actiontalesfanfict.wikia.com	Action Tales Wiki	es
es.aliens.wikia.com	Aliens Wiki	es
es.althistory.wikia.com	Historia Alternativa	es
es.animanga.wikia.com	Animanga Wiki	es
es.aviles.wikia.com	Avilés	es
es.batman.wikia.com	Batpedia	es
es.ben10.wikia.com	Ben 10 Wiki	es
es.bioshock.wikia.com	BioShock Wiki	es
es.bleach.wikia.com	Bleach Wiki	es
es.callofduty.wikia.com	Call of Duty Wiki	es
es.caniscanem.wikia.com	BullyPedia	es
es.casi-angeles.wikia.com	Casi Ángeles Wiki	es
es.cincoelementos.wikia.com	5 Elementos Wiki	es
es.cinechile.wikia.com	Cine de Chile	es
es.civilization.wikia.com	Civilopedia	es
es.csi.wikia.com	CSI Wiki	es
es.devilmaycry.wikia.com	Devil May Cry Wiki	es
es.dexter.wikia.com	Dexterpedia	es
es.diablo.wikia.com	Diablo Wiki	es
es.diablo3-esp.wikia.com	Diablo Wiki	es
es.dinorpg.wikia.com	Enciclopedia DinoRPG	es
es.dragon-quest.wikia.com	Dragon Quest Wiki	es
es.drakeandjosh.wikia.com	Drake y Josh Wiki	es
es.efeuno.wikia.com	Fórmula 1 Wiki	es
es.elrincondelsabio.wikia.com	Elrincondelsabio Wiki	es
es.enciclopediadg.wikia.com	Community Central	en
es.fallout.wikia.com	El Refugio	es
es.flashforward.wikia.com	Flashforward Wiki	es
es.fma.wikia.com	Fullmetal Alchemist Wiki	es
es.formula1.wikia.com	Wiki Fórmula 1	es
es.fringe.wikia.com	Fringe Wiki	es
es.fullcontact.wikia.com	Full Contact	es
es.futurama.wikia.com	Futurama Wiki	es
es.gearsofwar.wikia.com	GearsPedia	es
es.glee.wikia.com	Wiki Glee	es
es.godofwar.wikia.com	God of War Wiki	es
es.gta.wikia.com	Grand Theft Encyclopedia	es
es.guanakopedia.wikia.com	Guanakopedia Wiki	es
es.guipipedia.wikia.com	Güipipedia Wiki	es
es.habbo.wikia.com	HabboWiki - Wiki en español para HabboHotel	es
es.habbowars.wikia.com	Habbo Wars Wiki	es
es.halo.wikia.com	Halopedia	es
es.hattrick.wikia.com	Federaciones de Hattrick	es
es.heavymetal.wikia.com	Heavypedia	es
es.heroes.wikia.com	Heroes Wiki	es
es.hitman.wikia.com	Hitman Wiki	es
es.inheritance.wikia.com	InheriwikiEs	es
es.inuyasha.wikia.com	InuYasha Wiki	es
es.invasorzim.wikia.com	Wiki Invasor Zim	es
es.invizimals.wikia.com	Invizimals Wiki	es
es.jurassicpark.wikia.com	Jurassic Park Wiki	es
es.k-on.wikia.com	K-ON! Wiki	es
es.keroro.wikia.com	Wiki Keroro	es
es.kingdomhearts.wikia.com	Kingdom Hearts Wiki	es
es.kongreso.wikia.com	Kongreso Wiki	es
es.legogames.wikia.com	Wiki Videojuegos Lego	es
es.lostpedia.wikia.com	ES - Lostpedia	es
es.mafiawars.wikia.com	Mafia Wars en Español Wiki	es
es.manhunt.wikia.com	Manhunt Wiki	es
es.mario.wikia.com	Super Mario Wiki	es
es.marvel.wikia.com	Marvel Wiki	es
es.marvel-movies.wikia.com	Wiki Cine Marvel	es
es.masseffect.wikia.com	Mass Effect Wiki	es
es.matapedia.wikia.com	Matapedia Wiki	es
es.medabots.wikia.com	Medateca	es
es.megaman.wikia.com	Mega Man HQ	es
es.metalgear.wikia.com	Metal Gear Wiki	es
es.metroid.wikia.com	Metroidover	es
es.mortalkombat.wikia.com	Mortal Kombat	es
es.mynameisearl.wikia.com	My Name Is Earl	es
es.naruto.wikia.com	Naruto Wiki	es
es.narutoshippudenlatinobeta.wikia.com	Naruto Latino Wiki	es
es.ninjagaiden.wikia.com	Ninja Gaiden Black Wiki	es
es.nintendo.wikia.com	Nintendo Wiki	es
es.ogame.wikia.com	OGame Wiki	es
es.olocoons.wikia.com	Olocoons Wiki	es
es.onepiece.wikia.com	One Piece Wiki	es
es.pirategalaxy.wikia.com	Pirate Galaxy ES Wiki	es
es.pohlania.wikia.com	Pohlania Wiki	es
es.pokeespectaculos.wikia.com	Poke Espectaculos Wiki	es
es.pokefanon.wikia.com	La Wikia de Pokéfanon	es
es.pokemon.wikia.com	WikiDex	es
es.pokemongalaxy.wikia.com	Pokémon Galaxy Wiki	es
es.pokemononline-esp.wikia.com	Pokemononline español Wiki	es
es.pokemonpedia.wikia.com	Pokémonpedia Wiki	es
es.pokeonline.wikia.com	Pokémon Online Wiki	es
es.priston.wikia.com	PristonWiki	es
es.professorlayton.wikia.com	Profesor Layton Wiki	es
es.quimica.wikia.com	Química	es
es.ratchetandclank.wikia.com	Ratchet & Clank Wiki	es
es.reborn.wikia.com	Wiki Reborn	es
es.regnum.wikia.com	Regnum Online Wiki	es
es.residentevil.wikia.com	Resident Evil Wiki	es
es.rock.wikia.com	Rockpedia	es
es.runescape.wikia.com	RuneScape Wiki	es
es.saintseiya.wikia.com	Saint Seiya Wiki	es
es.sedna.wikia.com	Sedna Wiki	es
es.sherwooddungeon.wikia.com	Sherwood Dungeon Wiki	es
es.shippings.wikia.com	Shipping Wiki	es
es.silenthill.wikia.com	Silent Hill Wiki en español	es
es.simpsons.wikia.com	Simpson Wiki en Español	es
es.simpsonspediade2009.wikia.com	Simpsonspedia - Wiki en Español Wiki	es
es.sims.wikia.com	SimsPedia	es
es.smallville.wikia.com	Smallville en español	es
es.sonic.wikia.com	Sonic Wiki	es
es.southpark.wikia.com	Wiki South Park	es
es.spongebob.wikia.com	Bob Esponja Wiki	es
es.spore.wikia.com	Spore Wikia	es
es.ssb.wikia.com	SmashPedia	es
es.starwars.wikia.com	Star Wars Wiki	es
es.stephenking.wikia.com	Stephen King Wiki	es
es.superdex.wikia.com	SuperDex	es
es.swtor.wikia.com	SWTOR Wiki	es
es.tareasnormalseis.wikia.com	Tareasnormalseis Wiki	es
es.tekken.wikia.com	Tekken Wiki	es
es.thebeatles.wikia.com	The Beatles Wiki	es
es.thebigbangtheory.wikia.com	The Big Bang Theory Wiki	es
es.tibia.wikia.com	Tibia Wiki	es
es.ticnologia.wikia.com	Ticnologia Wiki	es
es.touhou.wikia.com	Touhou Español	es
es.transformers.wikia.com	Primuspedia	es
es.twikimetal.wikia.com	Twiki metal Wiki	es
es.twohalfmen.wikia.com	Wiki Two and a half men	es
es.uncharted.wikia.com	Wiki Uncharted	es
es.valve.wikia.com	Half-Life & Portal Wiki	es
es.vulpixpedia.wikia.com	Vulpixpedia Wiki	es
es.wakfu.wikia.com	Wakfu	es
es.wow.wikia.com	WarcraftWiki	es
es.wwve.wikia.com	The World Wrestling Virtual Entertainment Wiki	es
es.yonicpro.wikia.com	Yonicstudios 3.0 Wiki	es
es.yugioh.wikia.com	Yu-Gi-Oh! Wiki en Español	es
es.zelda.wikia.com	The Legend of Zelda Wiki	es
esm.wikia.com	Encyclopedia of Scale Models Wiki	en
esperanto.wikia.com	La malferma Esperanto-komunumo	eo
esrion.wikia.com	Esrion Wiki	en
essence.wikia.com	Essence Wiki	en
et.harrypotter.wikia.com	Harry Potter Wiki	et
et.parnu.wikia.com	Pärnu Wiki	et
eternal-lands.wikia.com	Eternal Lands Wiki	en
etrian.wikia.com	Etrian Odyssey Wiki	en
eu2opia.wikia.com	Empire Universe 2 Topia Wiki	en
evanius.wikia.com	Evanius	de
evchk.wikia.com	香港網絡大典	zh-hk
evctw.wikia.com	臺灣網絡百科	zh-tw
eve.wikia.com	EVE Wiki	en
everquest.wikia.com	EverQuest Wiki	en
evetaiwan.wikia.com	EVETaiwan	zh-tw
ewrestling.wikia.com	The eWrestling Encyclopedia	en
exaltedgreece.wikia.com	Exalted Greece	en
exo-force.wikia.com	Exo-Force Wiki	en
exo-squad.wikia.com	Exo-Squad Wiki	en
extraordinary.wikia.com	Extraordinary Wiki	en
eyeshield21.wikia.com	Eyeshield 21 Wiki	en
f2p-runescape.wikia.com	F2p runescape Wiki	en
fa.islam.wikia.com	ویکیای اسلام	fa
fa.shia.wikia.com	ویکیای شیعه	fa
fable.wikia.com	The Fable Wiki	en
fablefiction.wikia.com	Fable Fan Fiction Wiki	en
fablehaven.wikia.com	Fablehaven Wiki	en
facialhair.wikia.com	Facial Hair Wiki	en
fadingsunsstarwars.wikia.com	Fading Suns/Star Wars Crossover Wiki	en
fads.wikia.com	Fadwiki	en
fahrrad.wikia.com	Fahrrad-Wiki	de
fahrschule.wikia.com	Fahrschule	de
fairlyoddfanon.wikia.com	Fairly Odd Fanon Wiki	en
fairytailfanon.wikia.com	Fairy Tail Fanon Wiki	en
fallout.wikia.com	Fallout Wiki	en
falloutfanon.wikia.com	Fallout Fanon Wiki	en
familles.wikia.com	Wiki Familles	fr
familyguy.wikia.com	Family Guy Wiki	en
familymatters.wikia.com	Family Matters Wiki	en
familypedia.wikia.com	Familypedia	en
fanboy.wikia.com	Fanboy Wiki	en
fanfiction.wikia.com	Fan Fiction	en
fanloid.wikia.com	Fanloid Wiki	en
fanon.wikia.com	Fanon Wiki	en
fantage.wikia.com	The Fantage Wiki!	en
fantasygameworlds.wikia.com	Fantasy Game Worlds Wiki	en
fantendo.wikia.com	Fantendo - Nintendo Fanon Wiki	en
farbenmix.wikia.com	Farbenwiki	en
fargofilmmaking.wikia.com	Fargo Filmmaking	en
farmville.wikia.com	FarmVille Wiki	en
farscape.wikia.com	Farscape Encyclopedia Project	en
farstriders.wikia.com	Farstriders Community Wiki	en
fastmail.wikia.com	Community Central	en
fatalfury.wikia.com	Fatal Fury Wiki	en
fcu.wikia.com	Fairview Comics Wiki	en
federationnewsservice.wikia.com	ST_deep_space_9 Wiki	en
ferrocarriles.wikia.com	Ferropedia	es
fffanon.wikia.com	Final Fantasy Fanon	en
ffrpg.wikia.com	Final Fantasy RPG Wiki	en
fi.beepedia.wikia.com	Bee Wiki	fi
fi.biofanon.wikia.com	Bionicle Fanon wiki	fi
fi.bionicle.wikia.com	Bioarkistot	fi
fi.habbo.wikia.com	HabboWiki	fi
fi.ikariam.wikia.com	Finnish Ikariam Wiki	fi
fi.ilves.wikia.com	Ilves Wiki	fi
fi.lego.wikia.com	WikiPalikka	fi
fi.ratchet.wikia.com	Ratchet & Clank Wiki	fi
fi.runescape.wikia.com	RuneWiki	fi
fi.shakki.wikia.com	Shakki	fi
fi.spore.wikia.com	Spore Wiki	fi
fi.starwars.wikia.com	Jedipedia	fi
fi.wikigames.wikia.com	Wikigames Wiki	fi
fi.wow.wikia.com	WoWWiki Suomi	fi
fi.ww2books.wikia.com	WWII Books Wiki	fi
ficspecies.wikia.com	FicSpecies	en
fiction.wikia.com	Novelas	en
fiction-fighters.wikia.com	Fiction Fighters Wiki	en
fictional.answers.wikia.com	Fictional Wikianswers	en
fifa.wikia.com	FIFA Football Gaming wiki	en
fightingfantasy.wikia.com	Titannica	en
fightklubofficial.wikia.com	Official Fight Klub Wiki	en
fighunter.wikia.com	Figverse Wiki	en
figureskating.wikia.com	Figure Skating Wiki	en
fikcjatotalnejporazki.wikia.com	Fikcja Totalnej Porażki	pl
fileformats.wikia.com	File Formats Wiki	en
filmy.wikia.com	Filmopedia	pl
finalfantasy.wikia.com	Final Fantasy Wiki	en
fireemblem.wikia.com	Fire Emblem Wiki	en
firekeepers.wikia.com	Firewind Wiki	en
fishhooks.wikia.com	Fish Hooks Wiki	en
fishville.wikia.com	FishVille Wiki	en
fishwrangler.wikia.com	Fish Wrangler Wiki	en
fixpa.wikia.com	Fix PA	en
flags.wikia.com	VexiWiki	en
flapjack.wikia.com	Flapjack Wiki Harbor	en
flashforward.wikia.com	Flash Forward Wiki	en
flashgordon.wikia.com	Flash Gordon Wiki	en
flightoftheconchords.wikia.com	Flight of the Conchords Wiki	en
flipnoteartist.wikia.com	Flipnote Artist Wiki	en
floodians.wikia.com	The Flood Wiki	en
fmawiki.wikia.com	FMAWiki	de
foamipedia.wikia.com	Foamipedia Wiki	en
folc.wikia.com	FoLCdom Wiki	en
foldabots.wikia.com	Foldapedia	en
foldit.wikia.com	Foldit Wiki	en
fonline.wikia.com	Fallout Online Wiki	en
foodnetwork.wikia.com	Food Network Wiki	en
forceuser.wikia.com	Force User Wiki	en
foreverknight.wikia.com	Forever Knight Wiki	en
forgottenrealms.wikia.com	Forgotten Realms Wiki	en
formel1.wikia.com	Formel-1	de
forscherliga.wikia.com	Forscherliga-Wiki	de
forzamotorsport.wikia.com	Forza Motorsport Wiki	en
fossil.wikia.com	Fossil Wiki	en
foto.wikia.com	Fotowiki	de
fotomexico.wikia.com	Foto México Wiki	es
fr.assassinscreed.wikia.com	Wiki Assassin's Creed	fr
fr.borderlands.wikia.com	Wiki Borderlands	fr
fr.brunux.wikia.com	My Wiki page Wiki	fr
fr.communication.wikia.com	Communication Wiki	fr
fr.demange-le-jeu.wikia.com	Demange Wiki	fr
fr.diablo.wikia.com	Diablo wiki	fr
fr.film.wikia.com	Film Wiki	fr
fr.galactica.wikia.com	Galactic Wiki	fr
fr.gamebook.wikia.com	La Bibludothèque	fr
fr.grandfantasia.wikia.com	Grand Fantasia Wiki	fr
fr.guildwars.wikia.com	Guild Wars Wikia	fr
fr.halo.wikia.com	fr.Halopedia	fr
fr.harrypotter.wikia.com	Wiki Harry Potter	fr
fr.howto.wikia.com	Wikicomment	fr
fr.hunterxhunter.wikia.com	Wiki Hunter x Hunter	fr
fr.ikariam.wikia.com	Wiki Ikariam	fr
fr.ivbc.wikia.com	The Doors VBC Wiki	fr
fr.kingdomhearts.wikia.com	Kingdom Hearts Wiki	fr
fr.lba.wikia.com	Little Big Adventure Wiki	fr
fr.lesguignolsdelinfo.wikia.com	Les Guignols de l'Info Wiki	fr
fr.lostpedia.wikia.com	Lostpedia	fr
fr.lyrics.wikia.com	WikiaParoles	fr
fr.masseffect.wikia.com	Mass Effect Wiki	fr
fr.naruto.wikia.com	Naruto Wiki	fr
fr.narutopedie.wikia.com	Naruto Wiki	fr
fr.nature.wikia.com	Wikinature	fr
fr.onepiece.wikia.com	One Piece Encyclopédie	fr
fr.pes.wikia.com	PES en ligne	fr
fr.prisonbreak.wikia.com	Prison Break Wiki	fr
fr.rad20.wikia.com	Ra D20	fr
fr.rappelz.wikia.com	Rappelz	fr
fr.risen.wikia.com	Risen Wiki	fr
fr.runescape.wikia.com	WikiScape	fr
fr.sages.wikia.com	Sages	fr
fr.shaiya.wikia.com	Wiki Shaiya	fr
fr.simpsons.wikia.com	Wiki Les Simpson	fr
fr.snicket.wikia.com	Le Waterloeux Wiki des Orphelins Baudelaire	fr
fr.solarcooking.wikia.com	Solar Cooking	fr
fr.sonikku.wikia.com	Sonic Wiki	fr
fr.stargate.wikia.com	Wiki Stargate	fr
fr.wakfu.wikia.com	Wiki Wakfu	fr
fr.worldofkungfu.wikia.com	World of Kungfu Wiki	fr
fr.yugioh.wikia.com	Wikia Yu-Gi-Oh!	fr
fr.zelda.wikia.com	ZeldaWiki	fr
fragoriaus.wikia.com	Fragoria Wiki	en
freed20.wikia.com	Free d20	en
freedomdemocrats.wikia.com	Freedom Democrats Wiki	en
freekamenrider.wikia.com	Free Kamen Rider Wiki	en
freelancer.wikia.com	Freelancer Wiki	en
freerealms.wikia.com	FreeRealms Wiki	en
freespeech.wikia.com	Free Speech Wiki	en
freeware.wikia.com	Freeware Catalog	en
frenzy.wikia.com	Footmen Frenzy Compendium	en
fridaynightlights.wikia.com	Friday Night Lights Wiki	en
fridaythe13th.wikia.com	Friday the 13th Wiki	en
friends.wikia.com	Friends Central	en
fringe.wikia.com	FringeWiki	en
frontier.wikia.com	Community Central	en
fsa.wikia.com	FSA Wiki	en
fullhouse.wikia.com	Full House	en
fun.wikia.com	Wikifun	de
funorb.wikia.com	FunOrb Wiki	en
fury.wikia.com	FuryWiki	en
fushigiyuugi.wikia.com	Fushigi Yuugi Wiki	en
fusionfall.wikia.com	FusionFall Wiki	en
fussballenzyklopaedie.wikia.com	Fussball Wiki	de
fussballstatistiken.wikia.com	Fussballstatistiken-Wiki	de
futbol.wikia.com	Futbolpedia	es
futurama.wikia.com	Futurama Wiki	en
futuramafanon.wikia.com	Futurama Fanon	en
future.wikia.com	Future	en
futurediary.wikia.com	Future Diary Wiki	en
futurisma.wikia.com	Community Central	en
fzero.wikia.com	F-Zero Wiki	en
gabrielallon.wikia.com	Gabriel Allon Wiki	en
gadyakosh.wikia.com	Gadyakosh Wiki	hi
gaia.wikia.com	Gaiapedia	en
gakuenalice.wikia.com	Gakuen Alice Wiki	en
galactica.wikia.com	Battlestar Galactica Wiki	en
galacticbattles.wikia.com	Galactic Battles Wiki	en
galacticdefenders.wikia.com	Galactic Database	en
galacticimperium.wikia.com	Galactic Imperium Wiki	en
galactikfootball.wikia.com	Galactik Football Wiki	en
galaxia.wikia.com	Galaxia Wiki	en
galaxyangel.wikia.com	Galaxy Angel Wiki	en
galciv.wikia.com	Galactic Civilizations Wiki	en
gamemaker.wikia.com	Game Maker	en
gamergear.wikia.com	GamerGear Wiki	en
gaming.wikia.com	Encyclopedia Gamia	en
gamingmusic.wikia.com	Gaming Music Wiki	en
gantz.wikia.com	Gantz Wiki	en
gaogaigar.wikia.com	GaoGaiGar-Betterman Wiki	en
gardening.wikia.com	Gardening Wiki	en
garfield.wikia.com	Garfield Wiki	en
gatewayccg.wikia.com	Gateway: Return to Galwyndor Wiki	en
gateworldcantina.wikia.com	GateWorld Cantina Wiki	en
gateworldfleets.wikia.com	Gateworld Fleets	en
gearsofwar.wikia.com	Gears of War	en
geekfeminism.wikia.com	Geek Feminism Wiki	en
geneforge.wikia.com	Geneforge Wiki	en
genemarshall.wikia.com	Gene Marshall Wiki	en
general-hospital.wikia.com	General Hospital Wiki	en
generalarmory.wikia.com	The General Armory Wiki	en
geoism.wikia.com	Geoism Wiki	en
georgelopez.wikia.com	George Lopez Wiki	en
gerryanderson.wikia.com	Gerry Anderson Encyclopedia	en
geschichte.wikia.com	Deutsche-Geschichte-Wiki	de
gex.wikia.com	Gex wiki	en
gfo.wikia.com	Grand Fantasia Wiki	en
gibberish.wikia.com	Gibberpedia Wiki	en
gigasmagna.wikia.com	Gigas Magna Storyline Wiki	en
gijoe.wikia.com	Joepedia	en
gilmoregirls.wikia.com	Gilmore Girls Wiki	en
ginga.wikia.com	Ginga Wiki	en
gl.rock.wikia.com	Rock Music	gl
glee.wikia.com	Glee TV Show Wiki	en
glitches.wikia.com	Video Game Glitches Wiki	en
globalmedia.wikia.com	全球媒體研究室	zh-tw
globalmoney.wikia.com	Global Money Wiki	en
gmod.wikia.com	Garry's Mod Wiki	en
gmpc.wikia.com	Gnome Music Player Client	en
gmu.wikia.com	GMU Wiki	en
godofwar.wikia.com	God of War Wiki	en
godzilla.wikia.com	Wikizilla	en
goldeneye.wikia.com	GoldenEye Wiki	en
goldensun.wikia.com	Golden Sun Universe	en
goodeats.wikia.com	Good Eats	en
googology.wikia.com	Googology Wiki	en
gorillaz.wikia.com	Gorillaz Wiki	en
gossipgirl.wikia.com	Gossip Girl Wiki	en
gothamandbeyond.wikia.com	Gotham and Beyond Wiki	en
gothicworld.wikia.com	Gothic Wiki	en
government.wikia.com	Governance Wiki	en
gowfanon.wikia.com	Gears Of War Fanon	en
grabbedbytheghoulies.wikia.com	Ghoulipedia	en
gradius.wikia.com	Gradius Wiki	en
gran-turismo.wikia.com	Gran Turismo Wiki	en
grandchase.wikia.com	Grand Chase Wiki	en
granturismo5.wikia.com	Gran Turismo 5 Wiki	en
gratuitousspacebattles.wikia.com	Gratuitous Space Battles Wiki	en
gravity.wikia.com	Gravity Wiki	en
greatwar.wikia.com	Great War of Lordaeron Wiki	en
greegee.wikia.com	Greegee Wiki	en
greekmythology.wikia.com	Greek Mythology Wiki	en
greenarrow.wikia.com	Green Arrow Wiki	en
greenlantern.wikia.com	Green Lantern Wiki	en
greenpolitics.wikia.com	Green Politics	en
gremlins.wikia.com	Gremlins Wiki	en
greysanatomy.wikia.com	Grey's Anatomy and Private Practice Wiki	en
grouches.wikia.com	Grouches Wiki	en
gta.wikia.com	GTA Wiki	en
gtamusic.wikia.com	Grand theft auto/music Wiki	en
guardiansofgahoole.wikia.com	Guardians of Ga’Hoole Wiki	en
guildopedia.wikia.com	Guildopedia	en
guildwars2.wikia.com	GuildWiki2	en
guilty-gear.wikia.com	Guilty Gear Wiki	en
gundam.wikia.com	The Gundam Wiki	en
gunnerkrigg.wikia.com	Gunnerkrigg Court Wiki	en
gunslingergirl.wikia.com	Gunslinger Girl Wiki	en
gurrenlagann.wikia.com	Tengen Toppa Gurren Lagann Wiki	en
gymnastics.wikia.com	GymnWiki	en
h2o.wikia.com	H2O Just Add Water Wiki	en
habbo.wikia.com	Habbo Wiki	en
habbushletter.wikia.com	Habbush Letter Wiki	en
hadi.wikia.com	Fanonia SpongeBobia	en
haiti.wikia.com	Haiti	en
half-life.wikia.com	Half-Life Wiki	en
halloweenhorrornights.wikia.com	Halloween Horror Nights Wiki	en
halo.wikia.com	Halo Nation	en
halo.answers.wikia.com	Halo Answers	en
halofanon.wikia.com	Halo Fanon	en
halomachinima.wikia.com	Halo Machinima	en
hamtaro.wikia.com	The Hamtaro Wiki	en
handsme.wikia.com	Trey Wiki	en
handymanny.wikia.com	Handy Manny Wiki	en
hanna-barbera.wikia.com	Hanna-Barbera Wiki	en
hannahmontana.wikia.com	Hannah Montana Wiki	en
happypets.wikia.com	Happy Pets Wiki	en
happytreefanon.wikia.com	Happy Tree Friends Fanon Wiki	en
happytreefriends.wikia.com	Happy Tree Friends Wiki	en
hardyboys.wikia.com	The Hardy Boys Wiki	en
harryPotter.wikia.com	Harry Potter Wiki	en
harrybosch.wikia.com	Harry Bosch Wiki	en
harrypotterfanon.wikia.com	Harry Potter Fanon Wiki	en
haruhi.wikia.com	Haruhi Wiki	en
harvestmoondscute.wikia.com	Harvest Moon DS Cute Wiki	en
hasbroheroes.wikia.com	Hasbro Heroes Wiki	en
hashtags.wikia.com	WikiHashtags	en
havok.wikia.com	Havok Wiki	en
hawkman.wikia.com	Hawkman Wiki	en
hayatenogotoku.wikia.com	Hayate The Combat Butler Wiki	en
hdm.wikia.com	His Dark Materials	en
hdps.wikia.com	Henson Digital Puppetry Wiki	en
he-man.wikia.com	Wiki Grayskull	en
he.harrypotter.wikia.com	ויקיפוטר	he
he.hattrick.wikia.com	Hattrick	he
he.judaism.wikia.com	Judaism Wiki	he
he.lostpedia.wikia.com	Lost	he
he.naruto.wikia.com	נארוטו	he
headhuntersholosuite.wikia.com	Headhunter's Holosuite Wiki	en
headhuntershorrorhouse.wikia.com	Headhunter's Horror House Wiki	en
heavenmusic.wikia.com	LifeMusic Wiki	en
hellblazer.wikia.com	Hellblazer Wiki	en
hellboy.wikia.com	Hellboy Wiki	en
hellgate.wikia.com	HellgateDB	en
hellmoo.wikia.com	HellMOO Wiki	en
hellokittyonline.wikia.com	Hello Kitty Online Wiki	en
helloproject.wikia.com	Hello! Project Wiki	en
hellsing.wikia.com	Hellsing Wiki	en
herbolaria.wikia.com	Wiki Herbolaria	es
hereintherealm.wikia.com	The Realm Wiki	en
heroes.wikia.com	Heroes Wiki	en
heroesofgaia.wikia.com	Heroes of Gaia Wiki	en
heroesworld.wikia.com	Heroes World Wiki	en
herofactory.wikia.com	Heropedia	en
heroic-ages.wikia.com	Heroic Ages Wiki	en
heroscape.wikia.com	HeroScape Wiki	en
hetalia.wikia.com	Hetalia Archives	en
hetaliafanmadecharacters.wikia.com	Hetalia Fan Characters Wiki	en
hexer.wikia.com	Hexer-Wiki	de
heyarnold.wikia.com	Hey Arnold Wiki	en
hh.wikia.com	Hogan's Heroes	en
hi.literature.wikia.com	Hindi Literature	hi
hieloyfuego.wikia.com	Hielo y Fuego Wiki	es
high-school-musical.wikia.com	High School Musical Wiki	en
highlander.wikia.com	Highlander Wiki	en
highlandgames.wikia.com	Highland Games	en
him.wikia.com	HIM Wiki	en
history.wikia.com	Historical Codex	en
hitchhikers.wikia.com	Hitchhikers	en
hitman.wikia.com	Hitman Wiki	en
hkbus.wikia.com	香港巴士大典	zh-hk
hksschool.wikia.com	香港中學生大典	zh-hk
hohlbein.wikia.com	Enworpedia	de
hokuto.wikia.com	Hokuto Renkitōza	en
holdsteady.wikia.com	The Hold Steady Wiki	en
holic.wikia.com	Holic	en
hollenbach.wikia.com	Hollenbach Wiki	en
hollyoaks.wikia.com	Hollyoaks Wiki	en
hollywoodhoosiers.wikia.com	Hollywood Hoosiers Wiki	en
home.wikia.com	Home Wiki	en
homeimprovement.wikia.com	Home Improvement Wiki	en
homeworld.wikia.com	Encyclopedia Hiigara	en
honorverse.wikia.com	Honorverse	en
hoodup.wikia.com	Hoodup Wiki	en
horridhenry.wikia.com	Horrid Henry Wiki	en
horror-movies.wikia.com	Horror Film Wiki	en
hotel-lexikon.wikia.com	Hotel-Lexikon	de
hotelcaesar.wikia.com	Hotel Cæsar Wiki	no
hotrod.wikia.com	Hot Rod Wiki	en
hotwheels.wikia.com	Hot Wheels Wiki	en
hotwheelsbattleforce5.wikia.com	Hot Wheels Battle Force 5 Wiki	en
house.wikia.com	House Wiki	en
houstonrockets.wikia.com	Houston Rockets Wiki	en
how-i-met-your-mother.wikia.com	How I Met Your Mother Wiki	en
how-to.wikia.com	How To Wiki	en
howrsewiki.wikia.com	Howrse-Wiki	de
howtotrainyourdragon.wikia.com	How to Train Your Dragon Wiki	en
hr.dvojnamonarhija.wikia.com	Dvojna monarhija Wiki	hr
hr.ogame.wikia.com	Ogame Wiki	hr
hrwooky.wikia.com	Homestar Runner Wooky	en
hscr.wikia.com	Historical Stock Car Results Wiki	en
hu.assassinscreed.wikia.com	Assassin's Creed Wiki	hu
hu.bleachszerpjatek.wikia.com	Bleach Szerepjáték Wiki	hu
hu.dc.wikia.com	DC Database	hu
hu.esztergom.wikia.com	EsztergomWiki	hu
hu.fightingfantasy.wikia.com	Fighting Fantasy	hu
hu.ghalla.wikia.com	Ghalla Világa - Túlélők Földje Wiki	hu
hu.heroclix.wikia.com	Heroclix Wiki	hu
hu.heroesofmightandmagic.wikia.com	HoMMwiki	hu
hu.ikariam.wikia.com	Magyar WikIkariam	hu
hu.narnia.wikia.com	Magyar Narnia Wiki	hu
hu.naruto.wikia.com	Narutohun Wiki	hu
hu.net.wikia.com	Informatikai hálózatról magyarul	hu
hu.omagyar.wikia.com	Ómagyarország Wiki	hu
hu.shadowrun.wikia.com	Árnyékmagyarország	hu
hu.spam.wikia.com	WikiSpam	hu
hu.stargate.wikia.com	Stargate wiki	hu
hu.transformers.wikia.com	Transformers - Az Alakváltók	hu
hu.witcher.wikia.com	Witcher Wiki	hu
hu.wow.wikia.com	World of Warcraft Wiki	hu
hulk.wikia.com	Hulk Wiki	en
humancommunications.wikia.com	Human Communications Wiki	en
humanscience.wikia.com	Human Science	en
humongous.wikia.com	Humongous Entertainment Games Wiki	en
hundparadiset.wikia.com	Hundparadiset	sv
hunterxhunter.wikia.com	Hunterpedia	en
huntik.wikia.com	Huntik Wiki	en
hype-thetimequest.wikia.com	Hype Wiki	en
ial.wikia.com	International Auxiliary Languages	en
ibanez.wikia.com	Ibanez Wiki	en
icarly.wikia.com	iCarly Wiki	en
iceage.wikia.com	Ice Age Wiki	en
iceandfire.wikia.com	A Song of Ice and Fire Wiki	en
icehockey.wikia.com	Ice Hockey Wiki	en
id.islam.wikia.com	Ensiklopedia Islam	id
ideas.wikia.com	Idea Wiki	en
ideasintransit.wikia.com	Ideas in transit	en
ideenmanagement.wikia.com	Ideenmanagement	de
idhun.wikia.com	Widhún - Memorias de Idhún	es
idverse.wikia.com	Id Atlas	en
ikariam.wikia.com	Ikariam	en
ikkjepedia.wikia.com	Ikkjepedia	nn
ilercavonia.wikia.com	Ilercavònia	ca
illutia.wikia.com	Illutia Wiki	en
imagecomics.wikia.com	Image Comics Database	en
imagine.wikia.com	ImagineWiki	en
imario.wikia.com	Mario Wiki	en
imdb.wikia.com	IMDb Wikia	en
imdbrpg.wikia.com	IMDb RPG Wiki	en
impeach.wikia.com	Impeachment Wiki	en
imperiumao.wikia.com	Community Central	en
impossiblecreatures.wikia.com	Impossible Creatures Wiki	en
inciclopedia.wikia.com	Inciclopedia	es
incubatorplus.wikia.com	Incubator Plus	en
independajones.wikia.com	Independent thought Wiki	en
index.wikia.com	wiki网址导航	zh
india.wikia.com	India	en
indianajones.wikia.com	Indiana Jones Wiki	en
indianatco.wikia.com	Wiki for an Indian ATCO	en
indyfanfiction.wikia.com	Indiana Jones Fan Fiction	en
infiniteundiscovery.wikia.com	Infinite Undiscovery Wiki	en
infowars.wikia.com	Infowars Wiki	en
inheritance.wikia.com	Inheriwiki	en
innomine.wikia.com	In Nomine Wiki	en
inquiringmoms.answers.wikia.com	Inquiring Moms	en
insaniquarium.wikia.com	Insaniquarium Wiki	en
insects.wikia.com	Insect Wiki	en
inteq.wikia.com	INTEQ KB	pt
interlingua.wikia.com	Interlingua Wiki	ia
internationalbusiness.wikia.com	Community Central	en
internationalcricket.wikia.com	International Cricket Wiki	en
internet.wikia.com	Internet	en
inuyasha.wikia.com	InuYasha	en
invizimals.wikia.com	Invizimals Wiki	en
iphonegames.wikia.com	IOS Gaming Wiki	en
ippo.wikia.com	Wiki Ippo	en
iriscompendium.wikia.com	Ratchet And Clank Wiki	en
irishcomics.wikia.com	Irish Comics Wiki	en
irisonline.wikia.com	Iris Online Wiki	en
iron-man-armored-adventures.wikia.com	Iron Man: Armored Adventures Wiki	en
ironman.wikia.com	Iron Man Wiki	en
irregularwebcomic.wikia.com	Irregular Webcomic! Wiki	en
irwinallen.wikia.com	Irwin Allen Wiki	en
is.skoli.wikia.com	Skóli Wiki	is
ishar.wikia.com	Ishar Wiki	en
islam.wikia.com	Islam Wiki	en
islandparadise.wikia.com	Island Paradise Wiki	en
islandtrolltribes.wikia.com	Island Troll Tribes Official Wiki	en
issuingorders.wikia.com	Issuing Orders Wiki	en
istaria.wikia.com	Istaria Wiki	en
it.assassinscreed.wikia.com	Assassin's Creed Wiki	it
it.ben10.wikia.com	Ben 10 Wiki	it
it.cinema.wikia.com	Cinema Wiki	it
it.community.wikia.com	Wiki della Community	it
it.compvter.wikia.com	ComPVter	it
it.extremepokemon.wikia.com	Extreme Pokémon Wiki	it
it.farlands-it.wikia.com	Farlands Wiki	it
it.footstar.wikia.com	Footstar Wiki	it
it.gothic.wikia.com	Gothic Wiki	it
it.halo.wikia.com	Halopedia	it
it.harrypotter.wikia.com	Italian Harry Potter Wiki	it
it.horror.wikia.com	Horror Wiki	it
it.ikariam.wikia.com	Ikariam Wiki	it
it.kingdomhearts.wikia.com	Kingdom Hearts Italia Wiki	it
it.linux.wikia.com	LinuxWiki	it
it.lostpedia.wikia.com	Lostpedia Italia	it
it.lotr.wikia.com	Tolkienpedia	it
it.mandalorian.wikia.com	AuroraAllianceWiki	it
it.mario.wikia.com	Super Mario Italia Wiki	it
it.metin2.wikia.com	Metin 2 Wiki	it
it.naruto.wikia.com	NarutoPedia	it
it.nostradamus.wikia.com	Nostradamus Wiki	it
it.onepiece.wikia.com	One Piece Wiki Italia	it
it.residentevil.wikia.com	Resident Evil Wiki	it
it.simpsons.wikia.com	Simpsons Italia	it
it.soggettopedia.wikia.com	Community Central	en
it.squadraspecialecobra11.wikia.com	Squadra Speciale Cobra 11 Wiki	it
it.stargate.wikia.com	Stargate Wiki	it
it.starwars.wikia.com	Javapedia	it
it.teamninja.wikia.com	Team Ninja Wiki	it
it.witcher.wikia.com	Witcher Wiki	it
it.wow.wikia.com	WoWWiki Italia	it
it.yugioh.wikia.com	Yugioh Italian Wiki	it
itlaw.wikia.com	The IT Law Wiki	en
itsalwayssunny.wikia.com	It's Always Sunny in Philadelphia Wiki	en
ja.2ch.wikia.com	Monapedia	ja
ja.answers.wikia.com	ウィキ・アンサーズ	ja
ja.bebop.wikia.com	BE-BOP-HIGHSCHOOL Wiki	ja
ja.biohazard.wikia.com	BIO HAZARD Wiki	ja
ja.cell.wikia.com	ケータイ wikia	ja
ja.clubmusic.wikia.com	Clubmusic wiki	ja
ja.cognitivesciences.wikia.com	認知科学ウィキ こぐまにあ	ja
ja.doraemon.wikia.com	ドラえもん Wikia	ja
ja.eiga.wikia.com	映画ペディア	ja
ja.eq2.wikia.com	エバークエスト2 Wiki	ja
ja.fss.wikia.com	The Five Star Stories Wiki	ja
ja.game.wikia.com	ゲーム情報ウィキ	ja
ja.gcc.wikia.com	GCC Wikia	ja
ja.ginei.wikia.com	銀河英雄伝説 Wiki	ja
ja.gravity.wikia.com	Gravity Wiki	ja
ja.gundam.wikia.com	ガンダペディア	ja
ja.hagaren.wikia.com	鋼の錬金術師ウィキ	ja
ja.halo.wikia.com	Halopedia	ja
ja.harrypotter.wikia.com	Harry Potter Wiki	ja
ja.jump.wikia.com	週刊少年ジャンプ Wiki	ja
ja.kirby.wikia.com	カービィWiki	ja
ja.lotro.wikia.com	JaLotRO	ja
ja.machida.wikia.com	町田Wiki	ja
ja.macross.wikia.com	MACROSS Wiki	ja
ja.maipedia.wikia.com	Maipedia Wiki	ja
ja.mario.wikia.com	マリオペディア	ja
ja.maskedrider.wikia.com	仮面ライダー Wiki	ja
ja.railway.wikia.com	鉄道ウィキ	ja
ja.rfonline.wikia.com	RF Online Database	ja
ja.secondlife.wikia.com	Second Life in Japan	ja
ja.starwars.wikia.com	Wookieepedia	ja
ja.sukeban.wikia.com	スケバン刑事 Wiki	ja
ja.tanukipedia.wikia.com	たぬき Wiki	ja
ja.transformers.wikia.com	トランスフォーマー Wiki	ja
ja.ultraman.wikia.com	ウルトラマン Wiki	ja
ja.warhammeronline.wikia.com	Warhammer Online	ja
ja.xenepic.wikia.com	Xenepic Online Wiki	ja
ja.ymo.wikia.com	YMO Wikia	ja
jack.wikia.com	Jack Wiki	en
jackass.wikia.com	Jackass Wiki	en
jackiechanadventures.wikia.com	Jackie Chan Adventures Wiki	en
jadeempire.wikia.com	Jade Empire Wiki	en
jadeproductions.wikia.com	Jade Productions Wiki	en
jaggedalliance.wikia.com	Jagged Alliance Wiki	en
jakanddaxter.wikia.com	Jak and Daxter Wiki	en
james-camerons-avatar.wikia.com	Avatar Wiki	en
jamesbond.wikia.com	James Bond Wiki	en
japan.wikia.com	Japan	ja
jcafanon.wikia.com	Avatar Fanon Wiki	en
jericho.wikia.com	Jerichopedia	en
jet.wikia.com	WikiJET	en
jfc.wikia.com	John From Cincinnati Wiki	en
jhonenvasquez.wikia.com	Jhonen Vasquez Wiki	en
jimbaderfanon.wikia.com	Jim Bader Fanon Wiki	en
jimmyneutron.wikia.com	Jimmy Neutron Wiki	en
jimsteinman.wikia.com	Jim Steinman Wiki	en
jjba.wikia.com	JoJo's Bizarre Encyclopedia	en
johnnytest.wikia.com	Johnny Test Wiki	en
joinme.wikia.com	Join Me	en
jokes.wikia.com	Jokes Wiki	en
joseph10.wikia.com	Joseph 10 Wiki	en
journalism.wikia.com	Journawiki	en
judaism.wikia.com	Judaism	en
juggalos.wikia.com	Hatchetpedia	en
junkwars.wikia.com	Junk Wars Wiki	en
jurassicpark.wikia.com	Jurassic Park wiki	en
jurassicthehunted.wikia.com	Jurassic the Hunted Wiki	en
jusenkyo.wikia.com	Ranma 1/2 Fan Fiction Wiki	en
justbetween.wikia.com	Just Between Wikis	en
justcause.wikia.com	Just Cause Wiki	en
jutland.wikia.com	Distant Guns: Jutland	en
jvs.wikia.com	Jedi vs Sith Wiki	en
kaliman.wikia.com	Kaliman, el hombre increible	es
kamenrider.wikia.com	Kamen Rider Wiki	en
kaminomi.wikia.com	The World God Only Knows Wiki	en
kaminopedia.wikia.com	Kaminopedia	hu
kanjidamage.wikia.com	Japanese Synonym Wiki	en
kansascity.wikia.com	Kansas City	en
kanzaka.wikia.com	KanzakaDex	en
kapitanbomba.wikia.com	Kapitan Bomba Wiki	pl
katamari.wikia.com	Katamari Wiki	en
katyperry.wikia.com	The Katy Perry Wiki	en
kda.wikia.com	Kring Der Alchemisten	nl
kencyr.wikia.com	Kencyr Wiki	en
kenichi.wikia.com	History's Strongest Disciple Kenichi Wiki	en
kenshin.wikia.com	Rurouni Kenshin Wiki	en
kerli.wikia.com	Kerli Wiki	en
keroro.wikia.com	Keroro Wiki	en
keroro-gunso-orikero.wikia.com	Keroro Gunso: Orikero Wiki	en
kesha.wikia.com	Kesharose Wiki	en
kevin-smith.wikia.com	Kevin Smith Wiki	en
kgrpda.wikia.com	Keroro Gunso dA Roleplay Group Wiki	en
kickbuttowski.wikia.com	Kick Buttowski Wiki	en
kidchameleon.wikia.com	Kid Chameleon Wiki	en
kidicarus.wikia.com	Divinipedia	en
kidsmeal.wikia.com	Kids Meal Wiki	en
kidswb.wikia.com	Kids' WB! Wiki	en
kiepscy.wikia.com	Kiepscy Wiki	pl
killaschaaf.wikia.com	Killaschaaf	de
killerbunnies.wikia.com	Killer Bunnies Wiki	en
killzone.wikia.com	Killzone Wiki	en
kimpossible.wikia.com	Kim Possible Wiki	en
kingarthur.wikia.com	Quondam et Futurus	en
kingdomhearts.wikia.com	Kingdom Hearts Wiki	en
kingdomheartsfanfiction.wikia.com	Kingdom Hearts Fan Fiction	en
kingdomunderfire.wikia.com	Kingdom Under Fire Wiki	en
kinginyellow.wikia.com	The Yellow Site	en
kingoffighters.wikia.com	The King of Fighters Wiki	en
kingofthehill.wikia.com	King of the Hill Wiki	en
kingsquest.wikia.com	King's Quest Omnipedia	en
kinkontap.wikia.com	Kink On Tap Wiki	en
kinnikuman.wikia.com	Kinnikuman Wiki	en
kirby.wikia.com	Kirby Wiki	en
kirintor.wikia.com	Kirin Tor Wiki	en
kitsch.wikia.com	Kitsch and oddities	en
klingon.wikia.com	tlhIngan Hol	tlh
klonoa.wikia.com	Klonoa Wiki	en
knd.wikia.com	KND Code Module	en
knightmare.wikia.com	Knightmare Wiki	en
ko.campaigns.wikia.com	캠페인위키아	ko
ko.film.wikia.com	영화	ko
ko.gravity.wikia.com	Gravity Wiki	ko
ko.history.wikia.com	History Wiki	ko
ko.ldh.wikia.com	Ldh's Wiki	ko
ko.legal.wikia.com	리걸위키아	ko
ko.mabinogi.wikia.com	마비노기 위키아	ko
ko.medicine.wikia.com	Medicine	ko
ko.ogame.wikia.com	OGame 한국어 위키	ko
ko.pokemon.wikia.com	포켓몬 위키	ko
ko.woowong.wikia.com	Woowong Wiki	ko
koc.wikia.com	Kingdoms of Camelot Wiki	en
koei.wikia.com	Koei Wiki	en
kongregate.wikia.com	Kongregate Wiki	en
kore.wikia.com	한자위키	ko
korea.wikia.com	Korea	en
kormoran.wikia.com	Kormorán Wiki	hu
kosova.wikia.com	Kosova Wiki	en
krakow.wikia.com	Kraków Wiki	pl
kriollatino.wikia.com	Kriollatino	fr
kroniki-drugiego-kregu.wikia.com	Kroniki Drugiego Kręgu Wiki	pl
krspacet.wikia.com	KrspaceTfanfiction Wiki	en
ksf.wikia.com	Terrapedia Wiki	en
kuenstler.wikia.com	Künstler-Wiki	de
kuksoolwon.wikia.com	Kuk Sool Won	en
kumashii.wikia.com	Kumashii Wiki	en
kungfupanda.wikia.com	Kung Fu Panda Wiki	en
kuroshitsuji.wikia.com	Kuroshitsuji Wiki	en
kvortaro.wikia.com	Kriollatina Vortaro	fr
kyattounindenteyandee.wikia.com	Kyattou Ninden Teyandee Wiki	en
kylexy.wikia.com	Kyle XY Wiki	en
kyokaramaoh.wikia.com	Kyou Kara Maou!	en
l5r.wikia.com	L5r: Legend of the Five Rings Wiki	en
la.bibliotheca.wikia.com	Bibliotheca-Latina Wiki	la
lachfisch.wikia.com	Lachfisch	de
ladygaga.wikia.com	Gagapedia	en
landbeforetime.wikia.com	Land Before Time Wiki	en
landj.wikia.com	Wikilandj	li
lanormejuridique.wikia.com	La norme juridique	fr
laokia.wikia.com	Laokia Wiki	en
laracroft.wikia.com	Lara Croft Wiki	en
laruotadeltempo.wikia.com	La Ruota del Tempo Wiki	it
lastexile.wikia.com	Last Exile	en
lastremnant.wikia.com	The Last Remnant Wiki	en
lasvegas.wikia.com	Las Vegas	en
lawandorder.wikia.com	Law and Order	en
layton.wikia.com	Professor Layton Wiki	en
leagueoflegends.wikia.com	League of Legends Wiki	en
learningnote.wikia.com	Learning Notes	zh-cn
left.wikia.com	Left Space	en
left4dead.wikia.com	Left 4 Dead Wiki	en
left4dead11ty.wikia.com	Left 4 Dead Eleventy Wiki	en
leftbehind.wikia.com	Left Behind Wiki	en
legaciesofcormanthyr.wikia.com	Legacies of Cormanthyr	en
legaia.wikia.com	Legaia Wiki	en
legal.answers.wikia.com	Wikianswers Legal	en
legendofdragoon.wikia.com	The Legend of Dragoon Wiki	en
lego.wikia.com	Brickipedia	en
lego-fanon.wikia.com	LEGO Fanonpedia	en
lego.answers.wikia.com	Wikianswers LEGO	en
legoatlantis.wikia.com	Lego Atlantis Wiki	en
legobatman.wikia.com	LEGO Batman Wiki	en
legobrick.wikia.com	Lego Brick Wiki	en
legogames.wikia.com	LEGO Games Wiki	en
legoindianajones.wikia.com	Lego Indiana Jones Wiki	en
legometroid.wikia.com	Lego Metroid Wiki	en
legostarwars.wikia.com	Lego Star Wars Wiki	en
legostories.wikia.com	LEGO Stories Wiki	en
legouniverse.wikia.com	LEGO Universe Wiki	en
lemmings.wikia.com	Lemmings Wiki	en
lemondemon.wikia.com	Lemon Demon Wiki	en
lessthanjake.wikia.com	Less Than Jake Wiki	en
leverage.wikia.com	Leverage Wiki	en
lfn.wikia.com	Vici de LFN	en
lgbt.wikia.com	LGBT Info	en
liberapedia.wikia.com	Liberapedia	en
libero.wikia.com	Software Libero	it
liedboek.wikia.com	Hymnografie	nl
life-on-mars.wikia.com	Life on Mars Wiki	en
lifeafterpeople.wikia.com	Life After People Wiki	en
lineage2.wikia.com	Lineage 2 Wiki	en
linkinpark.wikia.com	Linkin Park Wiki	en
linux.wikia.com	Linux Wiki	en
lionking.wikia.com	The Lion King	en
list.wikia.com	WikiLists	en
literatura.wikia.com	Literatura Wiki	es
literature.wikia.com	Literawiki	en
littlebear.wikia.com	Little Bear Wiki	en
littlehouse.wikia.com	Little House on the Prairie Wiki	en
liverpoolfc.wikia.com	Liverpool FC Wiki	en
livingdeaddolls.wikia.com	Living Dead Dolls	en
livrejeu.wikia.com	Le livre dont vous êtes le héros	fr
lj-smith.wikia.com	L.J. Smith Wiki	en
loc2.wikia.com	Legends of Chance 2 Wiki	en
loclightvoid.wikia.com	Lords of Creation: Lightvoid Wiki	en
locopedia.wikia.com	Locopedia	de
lon.wikia.com	Legends of Norrath Wiki	en
london.wikia.com	London Wiki	en
londonbirders.wikia.com	London Bird Club Wiki	en
lonewolf.wikia.com	Lone Wolf	en
longislandmusicscene.wikia.com	Long Island Music Scene Wiki	en
looneytunes.wikia.com	Looney Tunes Wiki	en
lordsofcreation.wikia.com	Lords of Creation	en
lost.wikia.com	LOST	en
losthejourney.wikia.com	LostTheJourney Wiki	en
lostinspace.wikia.com	Lost in Space Wiki	en
lostodyssey.wikia.com	Lost Odyssey Wiki	en
lostpedia.wikia.com	Lostpedia	en
lostplanet.wikia.com	Lost Planet Wiki	en
lostthejourneytheconspiracyoftruth.wikia.com	Lost The Journey: The Conspiracy Of Truth Wiki	en
lotr.wikia.com	The One Wiki to Rule Them All	en
lotrfanon.wikia.com	LOTR Fanon	en
lotro.wikia.com	Lord of the Rings Online Wiki	en
lovecraft.wikia.com	The H.P. Lovecraft Wiki	en
lovehina.wikia.com	Love Hina Wiki	en
lpw.wikia.com	LPW Wiki	en
lt.biologija.wikia.com	Gyvoji gamta Wiki	lt
ltradio.wikia.com	Liberal Talk Radio Wiki	en
luckystar.wikia.com	Lucky Star Wiki	en
luminousarc.wikia.com	Luminous Arc Wiki	en
lunaonline.wikia.com	Luna Online Wiki	en
lunar.wikia.com	Lunar Wiki	en
lunia.wikia.com	Lunia Wiki	en
luxetumbra.wikia.com	Lux et Umbra	it
lxg.wikia.com	League of Extraordinary Gentlemen Wiki	en
lyceepasteur.wikia.com	Lycée Pasteur (São Paulo)	fr
lyoko.wikia.com	Code Lyoko WIKI	en
lyrics.wikia.com	LyricWikia	en
mabinogi.wikia.com	Mabinogi Wiki	en
macgyver.wikia.com	MacGyver Wiki	en
machinima.wikia.com	MachiPedia	en
macosken.wikia.com	Mac OS Ken Wiki	en
madagascar.wikia.com	Madagascar Wiki	en
madnesscombat.wikia.com	Madness Combat Wiki	en
madtv.wikia.com	Mad TV wiki	en
mafia.wikia.com	Mafia Wiki	en
mafia-wars.wikia.com	Mafia Wars Wiki	en
mafiagame.wikia.com	Mafia Wiki	en
mafiawars.wikia.com	Mafia Wars Wiki	en
magicaldoremi.wikia.com	Ojamajo Doremi Wiki	en
magicalstory.wikia.com	Magical Story Wiki	fr
magicduel.wikia.com	MagicDuel Wiki	en
magickverse.wikia.com	Magickverse Encyclopedia	en
magicschoolbus.wikia.com	The Magic School Bus Wiki	en
magictreehouse.wikia.com	The Magic Tree House Wiki	en
magination.wikia.com	Magi-Nation Wiki	en
magistream.wikia.com	Magistream Wiki	en
maisto.wikia.com	Maisto Diecast Wiki	en
makingfiends.wikia.com	Making Fiends Wiki	en
malazan.wikia.com	Malazan Wiki	en
malf.wikia.com	MAlf	en
malware.wikia.com	Malware Wiki	en
mana.wikia.com	Wiki of Mana	en
mancala.wikia.com	Mancala World	en
manga.wikia.com	Manga Wiki	en
mangalorean-catholics.wikia.com	Mangalorean Catholics Wiki	en
manhunt.wikia.com	Wikihunt	en
maoist.wikia.com	Maoist Wiki	en
maple-itcg.wikia.com	Maple iTCG Wiki	en
marapets.wikia.com	Marapedia	en
marathongame.wikia.com	Pfhorpedia	en
mario.wikia.com	MarioWiki	en
mariofanon.wikia.com	Super Mario Fanon	en
mariokart.wikia.com	Mario Kart Racing Wiki	en
mariokartwii.wikia.com	Mario Kart Wii Wiki	en
marjorie.wikia.com	Community Central	en
marki.wikia.com	Marki Wikia	pl
marley.wikia.com	Bob Marley Wiki	en
marthaspeaks.wikia.com	Martha Speaks Wiki	en
martianmanhunter.wikia.com	Martian Manhunter	en
marvel.wikia.com	Marvel Database	en
marvel-movies.wikia.com	Marvel Movies	en
marvelanimated.wikia.com	Marvel Animated Universe Wiki	en
marvelcomicsfanon.wikia.com	Marvel Fanon	en
marveldcfanfiction.wikia.com	Marvel Wiki	en
marveluniversemap.wikia.com	Marvel Universe Map Wiki	en
marvelvscapcom.wikia.com	Marvel vs. Capcom Wiki	en
mash.wikia.com	Monster M*A*S*H	en
masseffect.wikia.com	Mass Effect Wiki	en
masseffectfanfiction.wikia.com	Mass Effect Fan Fiction Wiki	en
mastergraywolf.wikia.com	MGW Works Wiki	en
matchbox.wikia.com	Matchbox Cars Wiki	en
math.wikia.com	Math Wiki	en
matrix.wikia.com	The Matrix Wiki	en
maxpayne.wikia.com	Max Payne Wiki	en
mayberry.wikia.com	Mayberry Wiki	en
mccp.wikia.com	Miniclip Club Penguin Forums Wiki	en
mcdonalds.wikia.com	McDonald's Wiki	en
mcleodgaming.wikia.com	McLeodGaming Wiki	en
meast.wikia.com	Middle East Modern History	he
mechquest.wikia.com	MechQuest Wiki	en
medabots.wikia.com	Medabots Wiki	en
medakabox.wikia.com	Medaka Box Wiki	en
medalofhonor.wikia.com	Medal of Honor Wiki	en
mediamusic.wikia.com	Media Music Wiki	en
medievallife.wikia.com	Medieval Life Wiki	en
medievil.wikia.com	Gallowmere Historia	en
meerkats.wikia.com	Meerkats Wiki	en
meerundmehr.wikia.com	MeerUndMehr - Fanfiction Writing Wiki	de
megaman.wikia.com	MMKB	en
megamanfanon.wikia.com	Mega Man Fanon Wiki	en
megamitensei.wikia.com	Megami Tensei Wiki	en
meme.wikia.com	Teh Meme Wiki	en
memory-beta.wikia.com	Memory Beta, non-canon Star Trek Wiki	en
memory-gamma.wikia.com	Memory Gamma	en
meninblack.wikia.com	Men in Black Wiki	en
mercs.wikia.com	Mercenaries Wiki	en
mercuryrisingfanon.wikia.com	Mercury Rising Fanon Wiki	en
meridiacampaignsetting.wikia.com	Meridia Campaign Setting Wiki	en
merlin.wikia.com	Merlin Wiki	en
mermaidmelody.wikia.com	Mermaid melody Wiki	en
merp.wikia.com	The Notion Club Archive	en
metal.wikia.com	Metal Wiki	en
metalgear.wikia.com	Metal Gear Wiki	en
metallica.wikia.com	Metallica Wiki	en
metalslug.wikia.com	Metal Slug Wiki	en
metro.wikia.com	Metro Wiki	en
metroid.wikia.com	Wikitroid	en
metroidfanon.wikia.com	Metroid Fanon Wiki	en
mets.wikia.com	New York Mets Wiki	en
mfbeyblade.wikia.com	Metal Fight Beyblade Wiki	en
mfg.wikia.com	MFG	en
mfgyugiohrpg2.wikia.com	MFG Yu-Gi-Oh! RPG Wiki	en
miamivice.wikia.com	Miami Vice Wiki	en
michael-jackson.wikia.com	Michael Jackson Wiki	en
micronaciones.wikia.com	Wiki Micronacional	es
micronations.wikia.com	MicroWiki	en
micropedia.wikia.com	Micropedia	pl
microsoft.wikia.com	Microsoft Wiki	en
middleman.wikia.com	The Middleman Wiki	en
midiancity.wikia.com	Midian City	en
midkemia.wikia.com	Midkemia Wiki	en
midnightcabaret.wikia.com	Midnight Cabaret Wiki	en
midnightsynergy.wikia.com	Midnight Synergy Wiki	en
midsomermurders.wikia.com	Midsomer Murders Wiki	en
mightandmagic.wikia.com	Might and Magic Wiki	en
mightymax.wikia.com	Mighty Max Wiki	en
mightythor.wikia.com	The Mighty Thor	en
military.wikia.com	Military Wiki	en
millionaire.wikia.com	Who Wants To Be A Millionaire Wiki	en
millsberry.wikia.com	Millsberry Wiki	en
mind-control.wikia.com	Контроль Разума	ru
minecraft.wikia.com	Minecraft Wiki	en
minigo.wikia.com	Minigo	de
miriadic.wikia.com	Miriadic	en
missingchildren.wikia.com	Missing Children Wiki	en
missionimpossible.wikia.com	Mission Impossible	en
mitosgriegoymas.wikia.com	Mitologia Griega	es
mittelalter.wikia.com	Mittelalter Wiki	de
mixedmartialarts.wikia.com	EDGE MMA	en
mkfusion.wikia.com	Mushroom Kingdom Fusion Wiki	en
mobsters2.wikia.com	Mobsters2 Wiki	en
mock-parliament.wikia.com	Mock Parliament Wiki	en
moddb.wikia.com	ModDB Wiki	en
modernfamily.wikia.com	Modern Family Wiki	en
monde.wikia.com	Monde	fr
monk.wikia.com	Monk Wiki	en
monkees.wikia.com	The Monkees Wiki	en
monkeyisland.wikia.com	Monkey Island Wiki	en
monopoly.wikia.com	Monopoly Wiki	en
monsaventinus.wikia.com	Mons Aventinus - The Aventine Hill	en
monsterblood.wikia.com	Monster Blood Tattoo Wiki	en
monsterhunter.wikia.com	Monster Hunter Wiki	en
monsterhunterfanon.wikia.com	Monster Hunter Fanon	en
monsterinmypocket.wikia.com	Monster in My Pocket Wiki	en
monsterrancher.wikia.com	Monster Rancher	en
montypython.wikia.com	Monty Python Wiki	en
moonguard.wikia.com	Moon Guard Wiki	en
mosh.wikia.com	My Own Shadow Wiki	en
moshimonsters.wikia.com	Moshi Monsters Wiki	en
motorcycles.wikia.com	Motorcycle Wiki	en
motorrad.wikia.com	Motorrad-Wiki	de
motorstorm.wikia.com	MotorStorm Wiki	en
mountandblade.wikia.com	Mount and Blade Wiki	en
movies.wikia.com	Moviepedia	en
mozilla.wikia.com	Mozilla Community	en
mpd.wikia.com	Music Player Daemon Community Wiki	en
mrmeaty.wikia.com	Mr. Meaty Wiki	en
mrmen.wikia.com	Mr. Men Wiki	en
mspaintadventures.wikia.com	MS Paint Adventures Wiki	en
mst3k.wikia.com	MST3K	en
mt.historialternativa.wikia.com	Community Central	en
mtg.wikia.com	Magic: The Gathering Wiki	en
mu.wikia.com	WikiMU*	en
mud.wikia.com	MUD Wiki	en
mugen.wikia.com	MUGEN Database	en
mughom.wikia.com	tlhIngan Hol mu'ghom	tlh
mummy.wikia.com	Rickipedia: The Mummy Wiki	en
munchkin.wikia.com	Munchkin Wiki	en
mungyodance.wikia.com	Mungyodance Wiki	en
muppet.wikia.com	Muppet Wiki	en
murciano.wikia.com	Wiki murciana	es
murdershewrote.wikia.com	The Murder, She Wrote Wiki	en
muscle.wikia.com	MUSCLEpedia	en
museums.wikia.com	Museums	en
music.wikia.com	Music Hub	en
musiikki.wikia.com	Musiikki Wiki	fi
musik.wikia.com	Musik-Wiki	de
muumitalo.wikia.com	Muumitalo	fi
mwal.wikia.com	Mwal Wiki	en
mybio.wikia.com	Community Central	en
mylegonetwork.wikia.com	My Lego Network Wiki	en
mynameisearl.wikia.com	My Name Is Earl Wiki	en
myparentsarealiens.wikia.com	My Parents Are Aliens Wiki	en
myra.wikia.com	MyraPedia	de
mysims.wikia.com	MySims Wiki	en
mysocalledlife.wikia.com	My So-Called Life Wiki	en
mysporeverse.wikia.com	MySporeverse Wiki	en
mythdrannor.wikia.com	Myth Drannor Wiki	en
mythology.wikia.com	Mythology Wiki	en
n.wikia.com	N	en
nachtwache.wikia.com	Forscherliga-Wiki	de
nagf.wikia.com	Grand Fantasia Wiki	en
nahko.wikia.com	North American Hello Kitty Online Wiki	en
naked.wikia.com	Community Central	en
namco.wikia.com	Namco Wiki	en
namcotales.wikia.com	The Namco Tales Forum Wiki	en
nao.wikia.com	Nao Wiki	en
narnia.wikia.com	The Chronicles of Narnia Wiki	en
naruto.wikia.com	Narutopedia	en
narutofanon.wikia.com	Narutopedia	en
narutooriginals.wikia.com	Naruto OC Wiki	en
nation.wikia.com	Wikination	en
nationalpedia.wikia.com	Nationalpedia Wiki	en
nationaltreasure.wikia.com	National Treasure Wiki	en
nationstates.wikia.com	WikiStates	en
nbcdaysofourlives.wikia.com	Days of our Lives Wiki	en
ncfcaopenness.wikia.com	NCFCA Openness Project Wiki	en
ncis.wikia.com	NCIS Database	en
neciklopedio.wikia.com	Neciklopedio	eo
necyklopedia.wikia.com	Necyklopédia	sk
necyklopedie.wikia.com	Necyklopedie	cs
needformadness.wikia.com	Need For Madness Wiki	en
negima.wikia.com	Negima! Wiki	en
neopets.wikia.com	NeoPets Guild	en
nerf.wikia.com	Nerf Wiki	en
nethack.wikia.com	Wikihack	en
netstorm.wikia.com	NetStorm Wiki	en
neverend.wikia.com	Neverend	en
neverendeon.wikia.com	Eon Wiki	en
newgrounds.wikia.com	Wikigrounds, the free Newgrounds encyclopedia	en
newmedia.wikia.com	What's new, new media?	en
newsboys.wikia.com	NewsBoys Wiki	en
newyork.wikia.com	New York	en
newzealand.wikia.com	New Zealand	en
nexus-one.answers.wikia.com	Wikianswers Nexus One	en
nfs.wikia.com	Need for Speed Wiki	en
nickelodeon.wikia.com	Nickelodeon	en
nickelodeonproductions.wikia.com	Nickelodeon Wiki	en
nickiminaj.wikia.com	Nicki Minaj Wiki	en
nicktoons.wikia.com	Nick Toons Wiki	en
nightlife.wikia.com	Nightlife	en
nightsdawn.wikia.com	Confederation Handwiki	en
nilgiri.wikia.com	Nilgiri Wiki	en
ninjagaiden.wikia.com	Ninja Gaiden Wiki	en
ninjasaga.wikia.com	Ninja Saga Wiki	en
nintendo.wikia.com	Nintendo	en
nintendogs.wikia.com	Nintendogs Wiki	en
nintendorocket.wikia.com	Nintendo Rocket Wiki	en
nitrome.wikia.com	Nitrome Wiki	en
niuflandia.wikia.com	Niuflandia	pl
nl.amaroth.wikia.com	Amaroth Wiki	nl
nl.avatar.wikia.com	Avatar Wiki	nl
nl.awf.wikia.com	AWF Wiki	nl
nl.bedrijven.wikia.com	Bedrijven Wiki	nl
nl.dragonball.wikia.com	Dragon Ball Wiki	nl
nl.duckstad.wikia.com	Duckstad Wiki	nl
nl.fabeltjeskrant.wikia.com	De Fabeltjeskrant Wiki	nl
nl.funorb.wikia.com	Funorb NL Wiki	nl
nl.harrypotter.wikia.com	Harry Potter Wiki	nl
nl.hpw.wikia.com	HPW Wiki	nl
nl.ikariam.wikia.com	Ikariam Wiki	nl
nl.koninkrijken.wikia.com	Koninkrijken der Renaissance	nl
nl.lostpedia.wikia.com	Lostpedia	nl
nl.musicaldatabase.wikia.com	Musical Database Wiki	nl
nl.nickelodeon.wikia.com	Nickelodeon Wiki	nl
nl.phineasandferb.wikia.com	Phineas en Ferb Wiki	nl
nl.pokemon.wikia.com	Nederlandse Pokémon Wiki	nl
nl.runescape.wikia.com	RuneScape Wiki	nl
nl.sap.wikia.com	Nederlandse SAP wiki	nl
nl.sonicnl.wikia.com	Sonic the Hedgehog Wiki	nl
nl.starwars.wikia.com	Star Wars Wiki	nl
nl.tibia.wikia.com	Tibia Wiki	nl
nl.tolkien-online.wikia.com	Tolkien wiki	nl
nl.wow.wikia.com	WoWWiki	nl
no.croxsdubbs.wikia.com	Crox dubbs Wiki	no
no.harrypotter.wikia.com	Harry Potter	no
no.m.wikia.com	Mpedia	no
no.ratchet.wikia.com	Ratchet & Clank	no
no.runescape.wikia.com	Norsk Runescape Wiki	no
no.sims.wikia.com	Simmenes Wiki	no
no.starwars.wikia.com	Star Wars Wiki	no
nodiatis.wikia.com	Nodiatis Wiki	en
nogginandnickjr.wikia.com	Nick Jr. Wiki	en
nohomers.wikia.com	Community Central	en
noir.wikia.com	Noir Wiki	en
nomoreheroes.wikia.com	No More Heroes Wiki	en
nonciclopedia.wikia.com	Nonciclopedia	it
nonsensopedia.wikia.com	Nonsensopedia	pl
norwichmusic.wikia.com	Norwich Music Wiki	en
nostale.wikia.com	Nostale Wiki	en
novanorway.wikia.com	Nova Norway	no
novebiologije.wikia.com	Nove Biologije	sl
nsc.wikia.com	Nation Song Contest	en
nt.wikia.com	Community Central	en
ntehl.wikia.com	NTEHL-Wiki	de
nuklearlord.wikia.com	Nuklear LoRD Wiki	en
nwn.wikia.com	NWNWiki	en
nwn2.wikia.com	NWN2Wiki	en
nwnenhanced.wikia.com	NWNEnhanced Wiki	en
nwnroleplayers.wikia.com	NWN Roleplayer's Wiki	en
o2jam.wikia.com	O2Jam wiki	en
oberin.wikia.com	OberinWiki	en
oc.wikia.com	The O.C. Wikia	en
oddworld.wikia.com	Oddworld	en
oelfke.wikia.com	Oelfke	de
offenbach.wikia.com	OffenbachWiki	de
ogame.wikia.com	OGame Wiki	en
ogrebattlesaga.wikia.com	Ogre Battle Saga Wiki	en
ogres.wikia.com	Ogres Wiki	en
ohmygoddess.wikia.com	Oh My Goddess	en
ojamajodoremi.wikia.com	Ojamajo Doremi Wiki	en
okami.wikia.com	Okami Wiki	en
ology.wikia.com	Ologypedia	en
olympics.wikia.com	Olympics Wiki	en
omegagroup.wikia.com	Omega Group Wiki	en
onelifetolive.wikia.com	One Life to Live Wiki	en
oneminuteago.wikia.com	One Minute Ago Wiki	en
onepiece.wikia.com	One Piece Encyclopedia	en
onepiecefanfiction.wikia.com	One Piece Fan Fiction Wiki	en
onepiecefanon.wikia.com	OnePiece Fanon Wiki	en
onetreehill.wikia.com	One Tree Hill Wiki	en
onimusha.wikia.com	Onimusha Wiki	en
onlyfoolsandhorses.wikia.com	Only Fools and Horses Wiki	en
oots.wikia.com	Order of the Stick Wiki	en
openarena.wikia.com	OpenArena	en
opensource.wikia.com	OpenSource	en
opensourcingreligion.wikia.com	NewReligionWiki	en
opinion.wikia.com	The Opinion Wiki	en
orchids.wikia.com	Orchids Wiki	en
oscarthegrouch.wikia.com	The Oscar the Grouch Wiki	en
otherverse.wikia.com	OtherVerse Wiki	en
otherworld.wikia.com	Otherworld Wiki	en
ottawa.wikia.com	Ottawa Wiki	en
ourbrant.wikia.com	Our Brant	en
overlord.wikia.com	Overlord Wiki	en
oz.wikia.com	Oz Wiki	en
p2.wikia.com	Tri-Sys-Com	de
packers.wikia.com	Packers Wiki	en
pacman.wikia.com	Pac-Man Wiki	en
padrino.wikia.com	Padrino Wiki	it
paesaggio.wikia.com	Paesaggio	it
pagan.wikia.com	WikiPagan	en
pagana.wikia.com	Encyclopaedia Pagana	fr
pakistan.wikia.com	Pakistan	en
paleontology.wikia.com	Paleontology Wiki	en
paltin.wikia.com	PAL-TIN Wiki	ro
pandoracomics.wikia.com	Pandora Comics Wiki	en
papermario.wikia.com	Paper Mario Wiki	en
paradisa.wikia.com	Paradisa Wiki	en
parasiteeve.wikia.com	Parasite Eve Wiki	en
pardus.wikia.com	Pardusian Database	en
parody.wikia.com	The Parody Wiki	en
particracy.wikia.com	Particracy Wiki	en
pasargada.wikia.com	Comunidade Livre de Pasárgada	pt-br
passagesofolos.wikia.com	The Passages of Olos	en
patapon.wikia.com	Patapon Wiki	en
pathfinder.wikia.com	PathfinderWiki	en
pc.wikia.com	Computing Knowledgebase	en
pcg.wikia.com	Paper Computer Games	en
pcsx2.wikia.com	PCSX2 Wiki	en
pdsh.wikia.com	Public Domain Super Heroes	en
peace.wikia.com	Peace Elements	en
peanuts.wikia.com	Peanuts Wiki	en
peel.wikia.com	John Peel Wiki	en
peelameal.wikia.com	Peel a Meal Wiki	en
peewee.wikia.com	Pee-Wee's Playhouse	en
peize.wikia.com	Peize	nl
pendragon.wikia.com	Pendragonpedia	en
pennyarcade.wikia.com	Penny Arcade	en
pepperann.wikia.com	Pepper Ann Wiki	en
perfectdark.wikia.com	Perfect Wiki	en
perfectworld.wikia.com	PWP WIKI	en
perfectworldinternational.wikia.com	Perfect World International Wiki	en
perl.wikia.com	Perl Wiki	en
permaculture.wikia.com	PermaWiki	en
pern.wikia.com	Pern Wiki	en
persona4.wikia.com	Persona 4 Wiki	en
petcare.wikia.com	Pet Care Wiki	en
petdiabetes.wikia.com	Diabetes in Pets	en
peterpan.wikia.com	Peter Pan Wiki	en
pets.answers.wikia.com	Wikianswers Pets	en
petville.wikia.com	PetVille Wiki	en
pffanon.wikia.com	Phineas and Ferb Fanon	en
pffollowers.wikia.com	PF Followers Wiki	en
pfremixxxxxx.wikia.com	Phineas and Ferb Remixx Wiki	en
pg2.wikia.com	Panzer General 2	en
pga.wikia.com	PGA Wiki	en
phantasystar.wikia.com	Phantasy Star Wiki	en
phantomtollbooth2.wikia.com	The Phantom Tollbooth 2 Wiki	en
philosophy.wikia.com	Philosophy	en
phineasandferb.wikia.com	Phineas and Ferb Wiki	en
phineasundferb.wikia.com	Phineas und Ferb Wiki	de
pickle.wikia.com	The Wikkle	en
pikmin.wikia.com	Pikmin	en
pikminfanon.wikia.com	Pikcanon-NOT	en
pinball.wikia.com	Pinball Wiki	en
pingu.wikia.com	Pingu Wiki	en
pinkfloyd.wikia.com	Pink Floyd	en
pirates.wikia.com	PotC Wiki	en
piratesonline.wikia.com	Pirates of the Caribbean Online Wiki	en
pixar.wikia.com	Pixar Wiki	en
pixarcars.wikia.com	Pixar Cars Wiki	en
pl.assassinscreed.wikia.com	Assassin's Creed Wiki	pl
pl.avatarlegendaaanga.wikia.com	Awatar Wiki	pl
pl.bakugan.wikia.com	Bakugan Wiki	pl
pl.bigpedia.wikia.com	Bigpedia Wiki	pl
pl.bleach.wikia.com	Bleach Wiki	pl
pl.callofduty.wikia.com	Call of Duty Wiki	pl
pl.cmdb.wikia.com	CMDb Wiki	pl
pl.custombionicles.wikia.com	Custom Bionicles PL	pl
pl.cybermycha.wikia.com	Cybermycha Wiki	pl
pl.desperate.wikia.com	Desperate Wikia	pl
pl.digimonuniverse.wikia.com	Digimon Universe Wiki	pl
pl.disney.wikia.com	Disney Wiki	pl
pl.djinni.wikia.com	Djinni Wiki PL	pl
pl.elderscrolls.wikia.com	Elder Scrolls Wiki	pl
pl.eu2pl.wikia.com	Empire universe 2 user Wiki	pl
pl.eurostarcontest.wikia.com	Wirtualny Konkurs Muzyczny	pl
pl.fallout.wikia.com	Krypta	pl
pl.fanonustarwars.wikia.com	Biblioteka Fanonu Star Wars	pl
pl.fineasziferb.wikia.com	Fineasz i Ferb Wiki	pl
pl.gupotopedia.wikia.com	Głupotopedia Wiki	pl
pl.harrypotter.wikia.com	Harry Potter Wiki	pl
pl.history.wikia.com	Historia Wiki	pl
pl.indianajones.wikia.com	Indiana Jones Wiki	pl
pl.james-camerons-avatar.wikia.com	Avatar Wiki	pl
pl.juventus.wikia.com	Juvepedia	pl
pl.lostpedia.wikia.com	Lostpedia	pl
pl.mistycalgroove.wikia.com	Mistycal Groove Region Wiki	pl
pl.narnia.wikia.com	Narnia Wiki	pl
pl.naruto.wikia.com	Naruto Wiki	pl
pl.nauka.wikia.com	Naukowa Wiki	pl
pl.off.wikia.com	Our Fantasy Festival Wiki	pl
pl.pokemononlinepl.wikia.com	Pokemon Online Wiki	pl
pl.politika.wikia.com	POLITIKA Wiki	pl
pl.rappelz.wikia.com	Rappelz Wikia Polska	pl
pl.residentevil.wikia.com	Resident Evil Wiki	pl
pl.runescape.wikia.com	RuneScape Wiki	pl
pl.rycerzefikcji.wikia.com	Rycerzefikcji Wiki	pl
pl.sailormoon.wikia.com	Czarodziejka z Księżyca Wiki	pl
pl.saintseiya.wikia.com	Saint Seiya Wiki	pl
pl.shadowrun.wikia.com	Shadowrun Wiki	pl
pl.sj3.wikia.com	Ski Jump International Wiki	pl
pl.spore.wikia.com	Wiki Spore	pl
pl.starwars.wikia.com	Empirepedia	pl
pl.sylvan.wikia.com	Sylvania Wiki	pl
pl.tombraider.wikia.com	Tomb Raider Wiki	pl
pl.transformers.wikia.com	Transformers Wiki	pl
pl.tvseries.wikia.com	Tvseries Wiki	pl
pl.wim.wikia.com	WIM Wiki	pl
pl.wow.wikia.com	WoWWiki	pl
pl.youtube.wikia.com	YouTube Wiki	pl
planetfanon.wikia.com	Planet Fanon Wiki	en
planetoftheapes.wikia.com	Planet of the Apes Wiki	en
planetoid3.wikia.com	Planetoid 3 Wiki	en
plantsvszombies.wikia.com	Plants vs. Zombies Wiki	en
plasniskpedia.wikia.com	Plasniskpedia	es
pmd.wikia.com	Pokémon Wiki	en
pocket-tanks.wikia.com	Pocket Tanks Wiki	en
poetry.wikia.com	Poetry Wiki	en
pogopedia.wikia.com	Pogopedia	de
pokemon.wikia.com	Pokémon Wiki	en
pokemoncrater.wikia.com	Pokemon Crater Wiki	en
pokemonfakemon.wikia.com	Pokemonfakemon Wiki	en
pokemonfanon.wikia.com	PokéFanon	en
pokemononlinegame.wikia.com	Pokemon Online Wiki	en
pokemonsonline.wikia.com	Pokemon Online Wiki	en
poker.wikia.com	Poker Wiki	en
polacy.wikia.com	Polacy Wiki	pl
polaqu.wikia.com	Dungeons and Dragons	en
policequest.wikia.com	Police Quest Omnipedia	en
polinapedia.wikia.com	Polinapedia	en
poluk.wikia.com	PolUKWiki	en
pooh.wikia.com	Winniepedia	en
poptropica.wikia.com	Poptropica Wiki	en
postal.wikia.com	Postal Wiki	en
potbs.wikia.com	PotBS Wiki	en
powerinstinct.wikia.com	Goketsuji Wiki	en
powerpuff.wikia.com	Powerpuff Girls Wiki	en
powerrangers.wikia.com	RangerWiki	en
powerrangerscentral.wikia.com	Power Rangers Wiki	en
powerrangersfanfiction.wikia.com	Power Rangers Fanon Wiki	en
powerrangersfanon.wikia.com	Power Rangers Fanon Wiki	en
poznan.wikia.com	Poznańska Wiki	pl
ppc.wikia.com	PPC Wiki	en
ppn.wikia.com	Wiki.ThePPN	en
premierepro.wikia.com	Adobe Premiere Pro	en
president.wikia.com	Presidentialpedia	en
prettycure.wikia.com	Pretty Cure Wiki	en
primeval.wikia.com	Anomaly Research Centre	en
princeofnothing.wikia.com	Prince of Nothing	en
princeofpersia.wikia.com	Prince of Persia Wiki	en
princeoftennis.wikia.com	Prince of Tennis Wikia	en
princessmaker.wikia.com	Princess Maker Wiki	en
prisonbreak.wikia.com	Prison Break Wiki	en
programnotes.wikia.com	Program Notes	en
projecthikari.wikia.com	HikariFalls Wiki	en
projectrunway.wikia.com	Project Runway Wiki	en
projects.wikia.com	Open project development	en
proteins.wikia.com	Proteins Wiki	en
protoscience.wikia.com	Protoscience	en
prototype.wikia.com	Prototype Wiki	en
prowrestling.wikia.com	Pro Wrestling	en
prowrestling.answers.wikia.com	Wikianswers Pro Wrestling	en
prydain.wikia.com	Prydain Wiki	en
przepisy.wikia.com	Przepisy Wiki	pl
psg.wikia.com	Panty & Stocking with Garterbelt Wiki	en
psi.wikia.com	PsiWiki	en
pspree.wikia.com	The Polyphonic Spree	en
psychoandy.wikia.com	EnPsychoPedia Wiki	en
psychology.wikia.com	Psychology Wiki	en
psychtv.wikia.com	Psychtv Wiki	en
psychusa.wikia.com	Psych Wiki	en
psytrancereleases.wikia.com	Psytrance Releases	en
pt-br.wikia.com	Wikia em Português	pt-br
pt-br.alias.wikia.com	Alias Wiki	pt-br
pt-br.avatar.wikia.com	Avatar Wiki	pt-br
pt-br.bibliotecamarista.wikia.com	Biblioteca Marista - Reino de Santa Maria Wiki	pt-br
pt-br.futurama.wikia.com	FuturamaWiki em Português	pt-br
pt-br.grandchase.wikia.com	Grand Chase Wiki	pt-br
pt-br.mecawiki.wikia.com	Meca-Wiki	pt-br
pt-br.phineaseferb.wikia.com	Phineas e Ferb Wiki	pt-br
pt-br.residentevil.wikia.com	Resident Evil	pt-br
pt-br.roseon.wikia.com	Rose On Wiki	pt-br
pt-br.saltcoverpedia.wikia.com	Coverpédia Wiki	pt-br
pt-br.sims.wikia.com	The Sims Wiki	pt-br
pt-br.supernatural.wikia.com	Supernatural Wiki	pt-br
pt-br.thiagolovato.wikia.com	Thiaggo Lovato Bell Wiki	pt-br
pt-br.wikiesponja.wikia.com	Wikiesponja Wiki	pt-br
pt-br.wwebrasil.wikia.com	Wwebrasil Wiki	pt-br
pt.amor.wikia.com	Sociedade do Amor	pt
pt.charmed.wikia.com	Charmed Wiki	pt
pt.chespirito.wikia.com	Chespiritopedia	pt
pt.christianmetal.wikia.com	White Metal Pedia	pt
pt.dbzpro2matrix.wikia.com	Dbzpro2matrix Wiki	pt
pt.desciclopedia.wikia.com	Desciclopédia Wiki	pt
pt.habbo.wikia.com	Habbo Hotel Wiki	pt-br
pt.historialternativa.wikia.com	Community Central	en
pt.hxh.wikia.com	Hunter x Hunter Wiki	pt
pt.kingdomhearts.wikia.com	Kingdom Hearts	pt
pt.lostpedia.wikia.com	LOSTpédia	pt
pt.metal.wikia.com	BloodMetal	pt
pt.micronations.wikia.com	Micronations	pt
pt.mortalkombat.wikia.com	Mortal Kombat Wikia	pt
pt.naruto.wikia.com	Narutopédia	pt
pt.onepiece.wikia.com	One Piece Wiki	pt
pt.otaku.wikia.com	Otakupédia	pt
pt.poesia.wikia.com	Poesia	pt
pt.prowrestling.wikia.com	Pro Wrestling Wiki	pt
pt.runescape.wikia.com	Runescape Wiki	pt
pt.saintseiya.wikia.com	Saint Seiya Wiki	pt-br
pt.simpsons.wikia.com	Wikisimpsons	pt-br
pt.spore.wikia.com	SporeWiki	pt
pt.starwars.wikia.com	Star Wars Wiki em Português	pt
pt.tekken.wikia.com	Tekken Wiki	pt
pt.tibia.wikia.com	TibiaWikiPT	pt
pt.touhou.wikia.com	Touhou Wiki	pt
pt.vvikipedia.wikia.com	Wikipédia Wiki	pt
pt.yugioh.wikia.com	Yu-Gi-Oh! Wiki	pt
publicdiplomacy.wikia.com	Public Diplomacy	en
publicidade.wikia.com	Publicidade	gl
pucca.wikia.com	Pucca	en
puppet.wikia.com	Puppet Wikia	en
pushing-daisies.wikia.com	Pushing Daisies Wiki	en
puzzlepirates.wikia.com	Puzzle Pirates	en
pwo.wikia.com	Poo World order Wikia	en
qpawn.wikia.com	Qpawn Wiki	en
quake.wikia.com	QuakeWiki	en
quaker.wikia.com	QuakerWiki	en
quantumleap.wikia.com	Quantum Leap Wiki	en
quest.wikia.com	Interactive Fiction Wiki	en
questforglory.wikia.com	Quest for Glory Omnipedia	en
quickipedia.wikia.com	Quickipedia	en
radiata.wikia.com	Radiatapedia	en
radiocontrol.wikia.com	RC Wiki	en
raganius.wikia.com	Raganius Wiki	lt
ranczo.wikia.com	Ranczopedia	pl
rangersapprentice.wikia.com	Ranger's Apprentice Wiki	en
ranma.wikia.com	Ranma Wiki	en
rap.wikia.com	Rap Wiki	en
rappelz.wikia.com	Rappelz Wiki	en
rare.wikia.com	RareWiki	en
ratchet.wikia.com	Ratchet & Clank wiki	en
ratchet-clank.wikia.com	Ratchet & Clank wiki	en
ratchetclankhumor.wikia.com	Blargipedia	en
ratchetfanfiction.wikia.com	Ratchet & Clank Fan Fiction	en
ravemaster.wikia.com	Rave Master Wiki	en
rayman.wikia.com	Rayman Wiki	en
raymond.wikia.com	Everybody Loves Raymond	en
rct.wikia.com	RollerCoaster Tycoon	en
readordie.wikia.com	Read or Die Wiki	en
realestate.wikia.com	Community Central	en
reallife.wikia.com	Real Life Comics	en
reaper-cw.wikia.com	Reaper Wiki	en
rebels.wikia.com	Star Wars Rebels Wiki	en
reboot.wikia.com	The ReBoot Wiki	en
reborn.wikia.com	Reborn Wiki	en
recess.wikia.com	Recess Wiki	en
recipes.wikia.com	Recipes Wiki	en
reddead.wikia.com	Red Dead Wiki	en
redfaction.wikia.com	Red Faction Wiki	en
redgreen.wikia.com	The Red Green Wiki	en
redskelton.wikia.com	Red Skelton Wiki	en
redwall.wikia.com	Redwall Wiki	en
regnum.wikia.com	Regnum Online Wiki	en
regularshow.wikia.com	Regular Show Wiki	en
reinosdarenascenca.wikia.com	Reinos da Renascença	pt
reinosrenacientes.wikia.com	Reinos Renacientes	es
religion.wikia.com	Religion-wiki	en
rem.wikia.com	R.E.M.	en
remingtonsteelers.wikia.com	Remington Steelers Wiki	en
remnantsofskystone.wikia.com	Remnants of Skystone Wiki	en
renaissancekingdoms.wikia.com	Renaissance Kingdoms	en
renesancnikralovstvi.wikia.com	Renesanční Království Wiki	en
renfaire.wikia.com	Renaissance Faire Wiki	en
reponses.wikia.com	Wikiréponses	fr
reptiles.wikia.com	Reptipedia	en
republiccommando.wikia.com	Republic Commando Wiki	en
republicleubantia.wikia.com	Leubantia Wiki	en
republicofadana.wikia.com	Adana Wiki	en
republique-froceuse.wikia.com	République de Frôce	fr
residentevil.wikia.com	Resident Evil Wiki	en
residentevilfanfiction.wikia.com	Resident Evil Fanon Wiki	en
resin.wikia.com	Resin Wiki	en
resistance.wikia.com	Resistance Wiki	en
respectthepouch.wikia.com	Disrespectiods Wiki	en
respostas.wikia.com	WikiRespostas	pt-br
respuestas.wikia.com	WikiRespuestas	es
reststops.wikia.com	Rest Stops and Service Plazas	en
reversopedia.wikia.com	Reversopedia	en
revival.wikia.com	Revival Wikia	en
revolt.wikia.com	Re-Volt the Wiki - Your Source For Everything Re-Volt	en
rezepte.wikia.com	Rezepte Wiki	de
riddick.wikia.com	Riddick Wiki	en
ridgeracer.wikia.com	Ridge Racer Wiki	en
rift.wikia.com	RIFT Wiki	en
rifts.wikia.com	Rifts Wiki	en
rippertales.wikia.com	Ripper Tales Wiki	en
riseofnations.wikia.com	Rise of Nations Wiki	en
riverafederationcenteral.wikia.com	RIVERA FEDERATION CENTERAL Wiki	en
ro.gta.wikia.com	GTA Wiki	ro
roach-busters.wikia.com	Roach Busters Wiki	en
robinhood.wikia.com	Robin Hood Wiki	en
roblox.wikia.com	ROBLOX Wikia	en
robocop.wikia.com	Robocop Wiki	en
robotchicken.wikia.com	Robot Chicken Wiki	en
robotech.wikia.com	Robotech Saga Wiki	en
robotwars.wikia.com	Robot Wars Wiki	en
rock.wikia.com	Rock Music Wiki	en
rockband.wikia.com	Rock Band Wiki	en
rocklee.wikia.com	Rock Lee's Springtime of Youth Wiki	en
rockosmodernlife.wikia.com	Rocko's Modern Life Wiki	en
rocky.wikia.com	Rocky Wiki	en
roguegalaxy.wikia.com	Rogue Galaxy Wiki	en
rohan.wikia.com	Rohan Wiki	en
rollercoaster.wikia.com	Roller Coaster Wiki	en
rom.wikia.com	Runes of Magic Wiki	en
romanchurches.wikia.com	Churches of Rome Wiki	en
romanica.wikia.com	Lingua Romanica Commun Unificata	en
rompedia.wikia.com	Rompedia	de
ronpaul.wikia.com	Ron Paul Grassroots	en
rosariovampire.wikia.com	Rosario + Vampire Wiki	en
roseanne.wikia.com	The Roseanne Wiki	en
roseonline.wikia.com	ROSE Online Wiki	en
roswell.wikia.com	Roswell Wiki	en
rougemuraille.wikia.com	Rougemuraille	fr
routes.wikia.com	WikiSara	fr
rowikicity.wikia.com	RoWikicity	ro
royalfamily.wikia.com	Royal Family Wiki	en
royalpains.wikia.com	Royal Pains Wiki	en
rpdimension.wikia.com	Dimension Number 2 Wiki	en
rpg.wikia.com	RPG	en
rpgarena.wikia.com	RPG Arena	en
rpggeneration.wikia.com	RPG-Generation	en
rpgmaker.wikia.com	RPG Maker Wiki	en
rpgresearch.wikia.com	RPG Research	en
rpgtalk.wikia.com	RPG Museum	en
ru.RPG.wikia.com	RPG	ru
ru.armacomref.wikia.com	ArmaCommandReference Wiki	ru
ru.avatar.wikia.com	Аватар Вики	ru
ru.battleforge.wikia.com	BattleForge ru Wiki	ru
ru.callofduty.wikia.com	Call of Duty Wiki	ru
ru.cbt.wikia.com	BattleTech Wiki	ru
ru.coincollecting.wikia.com	Coin Collecting Wiki	ru
ru.danzars.wikia.com	Хроники Данзарса	ru
ru.dragonage.wikia.com	Dragon Age Wiki	ru
ru.es-wow.wikia.com	ES Wiki	ru
ru.exmachina.wikia.com	Ex Machina Wiki	ru
ru.gta.wikia.com	Grand Theft Wiki	ru
ru.halo.wikia.com	HALO вики	ru
ru.harrypotter.wikia.com	Гарри Поттер вики	ru
ru.havenandhearth.wikia.com	Haven and Hearth Wiki	ru
ru.history.wikia.com	История Вики	ru
ru.hon.wikia.com	Heroes of Newerth RU Wiki	ru
ru.inheritance.wikia.com	Эрагон вики	ru
ru.lgbt.wikia.com	Информация о ЛГБТ по-русски	ru
ru.lostpedia.wikia.com	LOST	ru
ru.lotr.wikia.com	Википалантир	ru
ru.masseffect.wikia.com	Mass Effect Wiki	ru
ru.math.wikia.com	Математика	ru
ru.naruto.wikia.com	Наруто Вики	ru
ru.nationsim.wikia.com	NationSim Wiki	ru
ru.onepiece.wikia.com	One Piece Wiki	ru
ru.osdev.wikia.com	OSDev Wiki	ru
ru.ruerep.wikia.com	RueRep Wiki	ru
ru.science.wikia.com	Наука	ru
ru.smalltalk.wikia.com	Smalltalk по-русски	ru
ru.spore.wikia.com	Spore Wiki	ru
ru.stalker.wikia.com	S.T.A.L.K.E.R. Wiki	ru
ru.starwars.wikia.com	Вукипедия	ru
ru.tardis.wikia.com	Вики Доктор Кто	ru
ru.touhou.wikia.com	Русская Touhou Wiki	ru
ru.universaldramatica.wikia.com	Techno Wiki	ru
ru.vlab.wikia.com	Virtual Laboratory Wiki	ru
ru.wilderness.wikia.com	Wilderness Wiki	ru
ru.wow.wikia.com	WoWWiki	ru
ru.writers.wikia.com	Russian Writers	ru
ru.xop.wikia.com	Хор РХТУ им. Менделеева Wiki	ru
rugbyunion.wikia.com	Rugby Union	en
rugrats.wikia.com	Rugrats Wiki	en
ruleofrose.wikia.com	Rule of Rose Wiki	en
runefactory.wikia.com	Rune Factory Wiki	en
runescape.wikia.com	RuneScape Wiki	en
runescapeclans.wikia.com	RuneScape Clans Wiki	en
runescapeclassic.wikia.com	RuneScape Classic Wiki	en
runescapefanfiction.wikia.com	RuneScape Fan Fiction Wiki	en
ruse.wikia.com	R.U.S.E. Wiki	en
rush.wikia.com	Rush Wiki	en
rvb.wikia.com	Red vs. Blue Wiki	en
ryansean.wikia.com	Nigahiga Wiki	en
ryzom.wikia.com	Ryzom Wiki	en
s4league.wikia.com	S4 League Wikia	en
sabhakosam.wikia.com	Sabhakosam Wiki	ml
sabrinatheteenagewitch.wikia.com	Thesabrinatheteenagewitch Wiki	en
sacred.wikia.com	Sacred Wiki	en
saga.wikia.com	SaGa Wiki	en
saguys.wikia.com	SAWiki	en
saigen.wikia.com	Naruto Saigen: Wiki Edition Wiki	en
sailormoon.wikia.com	Sailor Moon Wiki	en
sailormoonenglishanime.wikia.com	Sailor Moon Dub Wiki	en
saintseiya.wikia.com	Seiyapedia	en
saintsrow.wikia.com	Saints Row Wiki	en
saiyuki.wikia.com	Saiyuki Wiki	en
salsrealm.wikia.com	Sal's Realm of Runescape Wiki	en
samandmax.wikia.com	Sam & Max Wiki	en
samuraipizzacats.wikia.com	Samurai Pizza Cats Wiki	en
san-francisco.answers.wikia.com	San Francisco Answers	en
sanctuary.wikia.com	The Sanctuary Network	en
sanfrancisco.wikia.com	San Francisco	en
sarchiuniverse.wikia.com	Sarchi Universe Wiki	en
saveourrights.wikia.com	Save Our Rights	en
sawfilms.wikia.com	Saw Movies	en
sawfish.wikia.com	Sawfish	en
sbhj.wikia.com	Community Central	en
sca21.wikia.com	Sustainable Community Action	en
scary.wikia.com	ScaryWiki	de
schoolcomputing.wikia.com	School Computing	en
schools.wikia.com	High School Online Collaborative Writing	en
schriftsteller.wikia.com	Schriftsteller-Lexikon	de
science.wikia.com	Open Science Wiki	en
scienceandmathacademy.wikia.com	Community Central	en
scienceeducation.wikia.com	Demonstration and Technology in Science Education	en
scientists.wikia.com	Scientists Wiki	en
scientology.wikia.com	Scientology	en
scifi.wikia.com	WikiSciFi	en
scifi-timeline.wikia.com	Sci Fi Timeline Wiki	en
sciriimperius.wikia.com	Sciri imperius	pt-br
scooby-doo.wikia.com	Scooby-Doo Wiki	en
scoobydoo.wikia.com	Scoobypedia	en
scooter.wikia.com	Scooter Wiki	en
scottpilgrim.wikia.com	Scott Pilgrim Wiki	en
scratchpad.wikia.com	Scratchpad	en
scream.wikia.com	Scream Wiki	en
scribble.wikia.com	Scribblenauts Wiki	en
scrubs.wikia.com	Scrubs Wiki	en
scum.wikia.com	WikiSCUM	en
sealonline.wikia.com	Seal Online Wiki	en
seansgaming.wikia.com	Sean's Gaming Wiki	en
seattle.wikia.com	Seattle Wiki	en
secondlife.wikia.com	Second Life Wiki	en
secretlife.wikia.com	The Secret Life of the American Teenager	en
secretofthesolstice.wikia.com	Secret of the Solstice Wiki	en
secretsaturdays.wikia.com	The Secret Saturdays Wiki	en
secretworld.wikia.com	The Secret World Wiki	en
sectorantioch.wikia.com	Sector Antioch Wiki	en
seekers.wikia.com	Seekers Wiki	en
sega.wikia.com	Sega Wiki	en
seinfeld.wikia.com	WikiSein	en
sekirei.wikia.com	Sekirei Wiki	en
sengokubasara.wikia.com	Sengoku BASARA Wiki	en
sentinels.wikia.com	Sentinels	en
septimusheap.wikia.com	Septimus Heap Wiki	en
settingup.wikia.com	Total Drama Roleplay Wiki	en
seuss.wikia.com	Dr. Seuss Wiki	en
sfery.wikia.com	Sferopedia	pl
sfhomeless.wikia.com	San Francisco Homeless Resource	en
sgtng.wikia.com	Stargate Wiki	en
shadowhearts.wikia.com	Shadowhearts Wiki	en
shadowhunters.wikia.com	The Shadowhunters' Wiki	en
shadownet.wikia.com	Shadow the Hedgehog Wiki	en
shadowrun.wikia.com	Shadowrun Wiki	en
shaiya.wikia.com	Shaiya Wiki	en
shakespeare.wikia.com	Shakespeare Wiki	en
shakugan.wikia.com	Shakugan no Shana Wiki	en
shamanking.wikia.com	Shaman King Wiki	en
shameless.wikia.com	Shameless Wiki	en
shannara.wikia.com	Shannara Wiki - Exploring the Magical World of Shannara	en
sharpe.wikia.com	Sharpe	en
sheezyrp.wikia.com	SARP Wiki	en
sherlockholmes.wikia.com	Baker Street Wiki	en
sherwooddungeon.wikia.com	Sherwood Dungeon Wiki	en
shining.wikia.com	Shining Wiki	en
shirtnumbers.wikia.com	Football Shirt Numbers Wiki	en
shmup.wikia.com	Shoot Em Up	en
shoresofwinter.wikia.com	Shores Of Winter Wiki	en
shrek.wikia.com	WikiShrek	en
shs.wikia.com	Surviving High School Wiki	en
shugochara.wikia.com	Shugo Chara Wiki	en
shyguy.wikia.com	Shy Guy Wiki	en
sigmastorm2.wikia.com	Sigma Storm 2	en
silentfilms.wikia.com	Silent Films Wiki	en
siliconvalley.wikia.com	Silicon Valley Commons	en
silverwing.wikia.com	Silverwing Wiki	en
simcity.wikia.com	SimCity	en
simcountry.wikia.com	Simcountry	en
simpsons.wikia.com	Simpsons Wiki	en
simpsonsfanon.wikia.com	Simpsons Fanon	en
sims.wikia.com	The Sims Wiki	en
simsfanon.wikia.com	The Sims Fanon Wiki	en
sinsofasolarempire.wikia.com	Sins of a Solar Empire	en
sk.katalog-minci.wikia.com	Katalog minci Wiki	sk
skateboarding.wikia.com	Skateboarding Wiki	en
skatoony.wikia.com	The Skatoony Wiki	en
skiesofarcadia.wikia.com	Skies of Arcadia Wiki	en
skins.wikia.com	Skins Wiki	en
skippyshorts.wikia.com	Skippy Shorts Wiki	en
skulduggery.wikia.com	Skulduggery Pleasant Wiki	en
skyrates.wikia.com	The Skybrary	en
sleepapnea.wikia.com	Sleep Apnea Wiki	en
sliders.wikia.com	Sliders Wiki	en
slipknot.wikia.com	Slipknot Wiki	en
slovnyk.wikia.com	Slovnyk Wiki	en
sluggy.wikia.com	Niftypedia	en
smallville.wikia.com	Smallville Wiki	en
smash4ideas.wikia.com	Super Smash Bros. Revolution Wiki	en
smbz.wikia.com	Super Mario Bros. Z Wiki	en
smstirling.wikia.com	S. M. Stirling Wiki	en
smurfs.wikia.com	Smurfs Wiki	en
snicket.wikia.com	Lemony Snicket Wiki	en
snk.wikia.com	SNK Wiki	en
snl.wikia.com	Saturday Night Live Wiki	en
snow.wikia.com	SnoWiki	en
so-you-think-you-can-dance.wikia.com	So You Think You Can Dance Wiki	en
soad.wikia.com	System of a Down Wiki	en
soaps.wikia.com	Soap Opera Wiki	en
soccer.wikia.com	Football Wiki	en
software.wikia.com	Software Wiki	en
solarcooking.wikia.com	Solar Cooking	en
solia.wikia.com	Solia Online Wiki	en
some-other.wikia.com	Some Other Wiki	en
sonic.wikia.com	Sonic News Network	en
sonicfanon.wikia.com	Sonic Fanon Wiki	en
sonicwings.wikia.com	Sonic Wings Wiki	en
sonicxseason4.wikia.com	Sonic x Season 4 Wiki	en
sonnywithachance.wikia.com	Sonny With a Chance Wiki	en
sonsofanarchy.wikia.com	Sons of Anarchy	en
sookiestackhouse.wikia.com	Southern Vampire Mysteries	en
sooty.wikia.com	Sooty Database Wiki	en
sopranos.wikia.com	The Sopranos Wiki	en
sorceleur.wikia.com	Sorceleur Wiki	fr
sot.wikia.com	Sword of Truth Wiki	en
sotf.wikia.com	Survival of the Fittest Wiki	en
sou.wikia.com	Scourge of Undeath Wiki	en
soulcalibur.wikia.com	Soulcalibur Wiki	en
souleater.wikia.com	Soul Eater Wiki	en
soundboardprankcalls.wikia.com	Soundboard Prank Calls Wiki	en
southpark.wikia.com	South Park Archives	en
southparkfanon.wikia.com	South Park Fanon Wikia	en
space.wikia.com	Space Wiki	en
spacecases.wikia.com	Space Cases Wiki	en
spacecolonization.wikia.com	Space Colonization Wiki	en
spacequest.wikia.com	Space Quest Omnipedia	en
spademanns.wikia.com	Spademanns Leksikon	da
spawn.wikia.com	Spawn Wiki	en
specops.wikia.com	Spec Ops Wiki	en
spectrobes.wikia.com	Spectrobes Wiki	en
speculativeevolution.wikia.com	Speculative Evolution Wiki	en
speedracer.wikia.com	Speed Racer	en
spellborn.wikia.com	Spellborn Wiki	en
spellforce.wikia.com	Spellforce Wiki	en
spelljammer.wikia.com	Spelljammer Wiki	en
spelunky.wikia.com	Spelunky Wiki	en
spicegirls.wikia.com	Spice Girls Wiki	en
spiderman.wikia.com	Spider-Man Wiki	en
spiele.wikia.com	Spiele	de
spineworld.wikia.com	Spineworld Wiki	en
spittingimage.wikia.com	Spitting Image Wiki	en
splintercell.wikia.com	Splinter Cell Wiki	en
spongeboard.wikia.com	Spongeboard	de
spongebob.wikia.com	Encyclopedia SpongeBobia	en
spongefan.wikia.com	SpongeBob Fanon Wiki	en
spooks.wikia.com	Spooks Wiki	en
spore.wikia.com	SporeWiki	en
square.wikia.com	Squarewiki	en
squidbillies.wikia.com	Squidbillies Wiki	en
sr.hoh.wikia.com	History of Humans	sr
sr.istorija.wikia.com	Историјска енциклопедија	sr
sryth.wikia.com	Sryth Wiki	en
ssbbcustom.wikia.com	SSBB Custom Content Wiki	en
ssu.wikia.com	Seiya Universe Wiki	en
stad.wikia.com	Wikistad	nl
stadtgeschichten.wikia.com	Stadtgeschichten-Wiki	de
stalker.wikia.com	S.T.A.L.K.E.R. Wiki	en
stamsr4.wikia.com	Stam Wiki	en
starcraft.wikia.com	StarCraft Wiki	en
starcraftfanfiction.wikia.com	Starcraft Fan Fiction Wiki	en
starfox.wikia.com	Arwingpedia	en
starfrontiers.wikia.com	Star Frontiers Wiki	en
starfrontiersrpg.wikia.com	Star Frontiers RPG Wiki	en
stargate.wikia.com	SGCommand	en
stargatefanprod.wikia.com	Stargate FanProd Wiki	en
stargatewars.wikia.com	Stargate Wars	en
stargateworlds.wikia.com	Stargate Worlds Wiki	en
starocean.wikia.com	Star Ocean Wiki	en
starships.wikia.com	Starships Wiki	en
starshiptroopers.wikia.com	Starship Troopers Wiki	en
startingstrength.wikia.com	Community Central	en
startopia.wikia.com	Startopia Wiki	en
startrekinfiniteuniverse.wikia.com	Star Trek: Infinite Universe Wiki	en
startrekonline.wikia.com	Star Trek Online Wiki	en
starwars.wikia.com	Wookieepedia	en
starwars-exodus.wikia.com	Star Wars: Exodus Visual Encyclopedia	en
starwarscrossover.wikia.com	Star Wars Crossover Wiki	en
starwarsfanworks.wikia.com	Star Wars Fanworks	en
starwarsmush.wikia.com	Star Wars Mush Wiki	en
starwarsphotonovels.wikia.com	Star Wars Photo Novels Wiki	en
starwarsplanets.wikia.com	Starwarsplanets Wiki	en
starwarsrpgtheforce.wikia.com	Star Wars SOTF RPG	en
state.wikia.com	Communist State Wiki	en
stc.wikia.com	Sonic the Comic Wiki	en
steampunk.wikia.com	Steampunk Wiki	en
stellardawn.wikia.com	Stellar Dawn Wiki	en
stephaniebrown.wikia.com	Stephanie Brown Wiki	en
stephenie-meyer.wikia.com	Twilight Saga Wiki	en
stephenking.wikia.com	Stephen King Wiki	en
stevecole.wikia.com	Steve Cole Books Wiki	en
stexpanded.wikia.com	Star Trek Expanded Universe	en
stokebynight.wikia.com	Stoke By Night Wiki	en
stooges.wikia.com	Stooges Wiki	en
storczyki.wikia.com	Storczyki Wiki	pl
stormhawks.wikia.com	Storm Hawks	en
stranded2.wikia.com	Stranded 2 Wiki	en
streetfighter.wikia.com	Street Fighter Wiki	en
students.wikia.com	Students	en
studio60.wikia.com	Studio 60 Wiki	en
stumbleupon.wikia.com	StumbleUpon Wiki	en
stupidmariobros.wikia.com	Stupid Mario Brothers Wiki	en
sueniverse.wikia.com	Encyclopedia Marysuenica	en
suikoden.wikia.com	Suikoden Wikia	en
suitelife.wikia.com	TiptonWiki	en
summonermaster.wikia.com	Summoner Master	en
sunderland.wikia.com	Sunderland A.F.C. Wiki	en
supcom.wikia.com	Supreme Commander Wiki	en
super.wikia.com	Super Wikia	en
super-smash-bros.wikia.com	Smashpedia	en
super400.wikia.com	Super 400 Wiki	en
superfriends.wikia.com	SuperFriends Wiki	en
superheroes.wikia.com	Superhero Wiki	en
superisaiahandsuperminzey.wikia.com	Super Isaiah and Super Minzey LX Wiki	en
superjail.wikia.com	Superjail Wiki	en
superman.wikia.com	Superman Wiki	en
supermariologan.wikia.com	Supermariologan Wiki	en
supermonkeyball.wikia.com	Super Monkey Ball Wiki	en
supernatural.wikia.com	Supernatural Wiki	en
superpower.wikia.com	SuperpowerWiki	en
superrobotwars.wikia.com	Super Robot Wars Wiki	en
supersmashbrosfanon.wikia.com	Super Smash Bros. Fanon	en
surfing.wikia.com	Surferpedia - The Wiki Encyclopedia of Surfing	en
survivor.wikia.com	Survivor Wiki	en
sv.gta.wikia.com	GTA Svenska	sv
sv.gtasajten.wikia.com	GTAsajtens GTA-Wiki	sv
sv.harrypotter.wikia.com	Harry Potter-wikin	sv
sv.simpsons.wikia.com	Simpsons Wiki	sv
sv.spelrecensioner.wikia.com	Spelrecensioner Wiki	sv
sv.starwars.wikia.com	Star Wars Wiki	sv
sv.tibia.wikia.com	Tibia Sweden Wiki	sv
svar.wikia.com	WikiSvar	no
svp.wikia.com	SVP Wiki	en
sw1mush.wikia.com	SW1ki	en
swfanon.wikia.com	Star Wars Fanon	en
swfans.wikia.com	Star Wars Fanpedia	en
swg.wikia.com	SWG Wiki	en
swgames.wikia.com	Star Wars Games	en
swiatmroku.wikia.com	Mroczna Wiki	pl
swmerchandise.wikia.com	Star Wars Merchandise Wiki	en
swminis.wikia.com	Star Wars Miniatures Wiki	en
swra.wikia.com	SWRApedia	de
swroleplay.wikia.com	SWRolePlaying Wiki	en
swrp.wikia.com	SWRPEDIA - Second Life Star Wars Roleplay Wiki	en
swrpg.wikia.com	The SWRPG Wiki	en
swtor.wikia.com	TOR Wiki	en
swtorcotf.wikia.com	Champions of the Force Wiki	en
swtoroff-topic.wikia.com	SWTOR Off-Topic Forum Wiki	en
swu.wikia.com	Wookieepedia	en
symbolism.wikia.com	Symbolism Wiki	en
syphonfilter.wikia.com	Syphon Filter Wiki	en
syrnia.wikia.com	Syrnia Wiki	en
sysadmin.wikia.com	The Sysadmin Wiki	en
tabularasa.wikia.com	TaRapedia	en
taggart.wikia.com	Taggart Wiki	en
tailsdoll.wikia.com	Tails Doll Wiki	en
taizhongbus.wikia.com	中公	zh-tw
tak.wikia.com	Tak and the Power of Juju Wiki	en
talesofdressing.wikia.com	Tales of Dressing Wiki	en
talesrunner.wikia.com	Tales Runner Wiki	en
taliscope.wikia.com	Taliscope Wiki	en
talismanonline.wikia.com	Talisman Online@Wikia	en
tamagotchi.wikia.com	Tamagotchi Wikia	en
tamorapierce.wikia.com	Tamora Pierce Wiki	en
tampabayhomeless.wikia.com	Tampa Bay Homeless Resource Wiki	en
tamsui.wikia.com	開放淡水	zh-tw
tanithlee.wikia.com	Tanith Lee Wiki	en
tardis.wikia.com	Tardis	en
tavistocksociety.wikia.com	The Tavistock Society Archives	en
taylorswift.wikia.com	Taylor Swift Wiki	en
tdafan4camp.wikia.com	TDAfan4 Wiki	en
tdar.wikia.com	TalkRadar Wiki	en
tdicamps.wikia.com	Total Drama Island Camp Wiki	en
tea.wikia.com	WikiTea	en
teamfortress.wikia.com	Team Fortress Wiki	en
teamico.wikia.com	Team Ico Wiki	en
technobabble.wikia.com	Technobabble Wiki	en
tecnologia.wikia.com	Tecnología Wiki	es
teenagerobot.wikia.com	The Wiki of a Teenage Robot	en
teentitans.wikia.com	Teen Titans Wiki	en
tekdiff.wikia.com	Tekdiff Wiki	en
tekken.wikia.com	Tekken Wiki	en
telefang.wikia.com	Wikiafang	en
telepath.wikia.com	Telepath RPG Wiki	en
templarsoftwilight.wikia.com	Twilight Templars Wiki	en
templates.wikia.com	Wikia Templates	en
tenchi.wikia.com	Tenchi Muyo Wiki	en
tenchu.wikia.com	Tenchu Wiki	en
tennis.wikia.com	Tennis Database Wiki	en
tera.wikia.com	TERA Wiki	en
terminator.wikia.com	Terminator Wiki	en
terradrive.wikia.com	TerraDrive	en
tesfanon.wikia.com	The Elder Scrolls Fanon	en
testemunhas.wikia.com	Enciclopédia das Testemunhas de Jeová	pt
testimonialmidgard.wikia.com	Testimonial Midgard	en
tetris.wikia.com	Tetris Wiki	en
tew.wikia.com	TEW Games Wiki	en
tfumux.wikia.com	Transformers Universe MUX	en
tga.wikia.com	The Gamer's Alliance Wiki	en
th.digimon.wikia.com	Digimon Wiki	th
th.typemoonpedia.wikia.com	Community Central	en
that70sshow.wikia.com	That '70s Wiki	en
thatguywiththeglasses.wikia.com	Channel Awesome	en
thatssoraven.wikia.com	That's So Raven wiki	en
the-house-of-anubis.wikia.com	House of Anubis Wiki	en
the404.wikia.com	The 404	en
theacademy.wikia.com	The Academy	en
thealchemyst.wikia.com	The Secrets Of The Immortal Nicholas Flamel Wiki	en
theanimeland.wikia.com	The AnimeLand Wiki	en
theaquabats.wikia.com	The Aquabats! Wiki	en
theatre.wikia.com	Theatre wiki	en
theawfulshow.wikia.com	Awfulpedia	en
thebakapedia.wikia.com	Bakacosplay Wiki	en
thebill.wikia.com	The Bill Wiki	en
thebreaker.wikia.com	The Breaker Wiki	en
theclique.wikia.com	The Clique	en
theculture.wikia.com	The Culture Wiki	en
thedaillymet.wikia.com	New York Mets Wiki	en
thedarkness.wikia.com	The Darkness Wiki	en
theedgechronicles.wikia.com	The Edge Chronicles wiki	en
theelectriccompany.wikia.com	Electric Company Wiki	en
theflash.wikia.com	The Flash Wiki	en
thegetaway.wikia.com	The Getaway Wiki	en
thegungancouncil.wikia.com	The Gungan Council	en
thehermeticfantasygame.wikia.com	MUSE: The hermetic fantasy game Wiki	en
theiceage.wikia.com	Ice Age Wiki	en
theitcrowd.wikia.com	The IT Crowd Wiki	en
thejetsons.wikia.com	The Jetsons Wiki	en
thelegacychronicles.wikia.com	The Legacy Chronicles Wiki	en
thelionkingfanon.wikia.com	The Lion King Fanon Wiki	en
thementalist.wikia.com	The Mentalist Wiki	en
themostrandom.wikia.com	The most random Wiki	en
theodoretugboat.wikia.com	Theodore Tugboat Wiki	en
theoffice.wikia.com	Dunderpedia: The Office Wiki	en
therian.wikia.com	Therianthropy	en
thermo.wikia.com	My Hero Wiki	en
theshatareu.wikia.com	The Sha'tar EU	en
theshield.wikia.com	The Shield Wiki	en
theskytides.wikia.com	The Sky Tides Wiki	en
thethreekingdoms.wikia.com	Gongjin's Campaign Memorials	en
thetribe.wikia.com	The Tribe Wiki	en
thetroop1.wikia.com	The Troop Wiki	en
thewaltons.wikia.com	The Waltons Wiki	en
thewarriors.wikia.com	The Warriors	en
theweddingpresent.wikia.com	The Wedding Present Wiki	en
thewire.wikia.com	The Wire	en
theworldcc.wikia.com	The World CC	en
theyoungandtherestless.wikia.com	The Young and the Restless Wiki	en
thief.wikia.com	Thief Wiki	en
thomasfanon.wikia.com	Thomas Fanon Wiki	en
thomaswoodenrailway.wikia.com	Thomas Wooden Railway Wiki	en
threeworlds.wikia.com	The Three Worlds Wiki	en
thundercats.wikia.com	ThunderCats wiki	en
thundercatslair.wikia.com	Thundercats Wiki	en
tibasic.wikia.com	TI-BASIC Wiki	en
tibia.wikia.com	TibiaWiki	en
timanderic.wikia.com	Tim and Eric Wiki, Great Job!	en
timburton.wikia.com	Tim Burton Wiki	en
timesplitters.wikia.com	TimeSplitters Wiki	en
tinierme.wikia.com	TinierMe Wiki	en
tintin.wikia.com	Tintin Wiki	en
tinytoons.wikia.com	Tiny Toon Adventures Wiki	en
tipitaka.wikia.com	Wikipitaka - The Completing Tipitaka	en
titanlegends.wikia.com	Titan Legends Wiki	en
titanquest.wikia.com	Titan Quest Wiki	en
tku.wikia.com	淡江人維基網	zh-tw
tl.runescape.wikia.com	Tagalog RuneScape Wiki	tl
tlbbeu.wikia.com	TLBB EU Wiki	en
tlj.wikia.com	TLJwiki	en
tmnt.wikia.com	TMNTPedia	en
tmp2.wikia.com	The Millennial Project 2.0	en
toarumajutsunoindex.wikia.com	Toaru Majutsu no Index Wiki	en
toastmasters.wikia.com	Toastmasters International	en
tokipona.wikia.com	Wikipesija	en
tokusatsu.wikia.com	Tokupedia	en
tokyomewmewpower.wikia.com	Tokyo Mew Mew Wiki	en
tolololpedia.wikia.com	Tolololpedia	id
tomandjerry.wikia.com	Tom and Jerry Wiki	en
tomclancy.wikia.com	Tom Clancy Wiki	en
toohuman.wikia.com	Too Human Database	en
toontown.wikia.com	Toontown Wiki	en
topgear.wikia.com	Top Gear Wiki	en
toptrumps.wikia.com	Top Trumps Wiki	en
torchlight.wikia.com	Torchlight Wiki	en
toronto-blue-jays.wikia.com	Toronto Blue Jays Wiki	en
toronto-maple-leafs.wikia.com	Toronto Maple Leafs Wiki	en
toryumonjapan.wikia.com	Dragon System Wiki	en
totalannihilation.wikia.com	Total Annihilation Wiki	en
totaldrama.wikia.com	Total Drama Wiki	en
totaldramacomeback.wikia.com	Total Drama Comeback Wiki	en
totaldramaislandfanfiction.wikia.com	Total Drama Island Fanfiction wikia	en
totaldramaroleplay.wikia.com	Community Central	en
totalwar.wikia.com	Total War Wiki	en
totalwaruniverse.wikia.com	Total War Universe Wiki	en
touhou.wikia.com	Touhou Wiki	en
toys.wikia.com	Toys Wiki	en
tr.wow.wikia.com	WoWWiki Türkçe	tr
tractors.wikia.com	Tractor & Construction Plant Wiki	en
tradycja.wikia.com	Encyklopedia Tradycji	pl
trailerpark.wikia.com	Trailer Park Wiki	en
trains.wikia.com	Le monde des chemins de fer	fr
traitorgame.wikia.com	Traitor Game Wiki	en
trams.wikia.com	Worldwide Trams Wiki	en
transfanon.wikia.com	Transformers Fanon Wiki	en
transformers.wikia.com	Teletraan I: The Transformers Wiki	en
transformers2005.wikia.com	Transformers2005 MUSH Wiki	en
transhumanism.wikia.com	Transhumanism Wiki	en
translation.wikia.com	Language Brigade Wiki	en
traumacentergame.wikia.com	Caduceus Database	en
travel.wikia.com	Wikia Travel	en
traveller.wikia.com	Traveller Wiki	en
travian.wikia.com	Travian	en
treasuremadness.wikia.com	Treasure Madness Wiki	en
tremors.wikia.com	Tremors Wiki	en
tribalwars.wikia.com	Tribal Wars Wiki	en
tribes.wikia.com	Tribes Wiki	en
trigun.wikia.com	Trigun Wiki	en
tron.wikia.com	Tron Wiki	en
trophymanager.wikia.com	Trophy Manager Wiki	en
tropico.wikia.com	Tropico Wiki	en
trpgkorea.wikia.com	TRPG 한국어 Wiki	ko
trsg.wikia.com	The Rock Star Game Wiki	en
trueblood.wikia.com	True Blood Wiki	en
tsrp.wikia.com	The Specialists Roleplay Wiki	en
tsubasa.wikia.com	Tsubasa Chronicle Wiki	en
tsukuba.wikia.com	Tsukuba Wiki	en
tta.wikia.com	Terran Trade Authority Handbook	en
ttfanon.wikia.com	Theodore Tugboat Fanon Wiki	en
ttte.wikia.com	Thomas the Tank Engine Wikia	en
tttefanon.wikia.com	TTTEFanon Wiki	en
tugs.wikia.com	Tugs Wiki	en
tugsfanon.wikia.com	TUGS Fanon	en
turok.wikia.com	Turok Wiki	en
turtledove.wikia.com	Turtledove	en
twelvesands.wikia.com	Twelve Sands Wiki	en
twewy.wikia.com	The World Ends With You	en
twf.wikia.com	Thumb Wrestling Federation Wiki	en
twilight2000.wikia.com	Twilight 2000 Wiki	en
twilightsaga.wikia.com	Twilight Saga Wiki	en
twilightzone.wikia.com	The Twilight Zone Wiki	en
twinpeaks.wikia.com	Twin Peaks Wikia	en
twistedmetal.wikia.com	Twisted Metal Wiki	en
twit.wikia.com	TWiTcity	en
twohalfmen.wikia.com	Two and a Half Men Wiki	en
twoworlds.wikia.com	Two Worlds Wiki	en
tygame.wikia.com	Ty Wiki	en
typemoon.wikia.com	TYPE-MOON Wiki	en
ucberkeley.wikia.com	UC Berkeley Wiki	en
ufoaliendatabase.wikia.com	UFO-Alien Database	en
ufstcg.wikia.com	Universal Fighting Wiki	en
uglybetty.wikia.com	Ugly Betty Wiki	en
uiquipedia.wikia.com	Uiquipèdia	val
ukchartmusic.wikia.com	Uk Chart Music Wiki	en
ukcomics.wikia.com	UK Comics Wiki	en
ukhousing.wikia.com	UK Housing Wiki	en
ukroads.wikia.com	UK Roads	en
uktransport.wikia.com	UK Transport Wiki	en
ultima.wikia.com	Editable Codex	en
ultimatepopculture.wikia.com	Ultimate Pop Culture Wiki	en
ultra.wikia.com	Ultraman Wiki	en
unanything.wikia.com	UnAnything Wiki	en
unbeliever.wikia.com	The Chronicles of Thomas Covenant, the Unbeliever Wiki	en
unbionicle.wikia.com	Unbionicle Wiki	en
uncg.wikia.com	Spartan Survival Guide	en
uncharted.wikia.com	Uncharted Wiki	en
unclubpenguin.wikia.com	Community Central	en
underland.wikia.com	The Underland Cyclopedia	en
ungdomshuset.wikia.com	Ungeren-wiki	da
unhalo.wikia.com	Gruntipedia	en
unicode.wikia.com	Unicode discussion	en
unitedmarvelfilms.wikia.com	Marvel Films United Wiki	en
units.wikia.com	Units of Measurement Wiki	en
universalmonsters.wikia.com	Universal Monsters Wiki	en
universeatwar.wikia.com	Universe At War	en
unline.wikia.com	Underground Online Wiki	en
unmario.wikia.com	UnMarioWiki	en
unpokemon.wikia.com	UnPokemon	en
unreal.wikia.com	Unreal Wiki	en
unrealworld.wikia.com	Unreal World Wiki	en
unsolvedmysteries.wikia.com	Unsolved Mysteries Wiki	en
urban-rivals.wikia.com	Urban Rivals Wiki	en
urusei.wikia.com	Urusei Yatsura Wiki	en
usertendo.wikia.com	Usertendo	en
usmodernculture.wikia.com	Modern US Culture Wiki	en
ussswiftfire.wikia.com	Star Trek: The Farthest Star Wikia	en
utaite.wikia.com	Utaite Wiki	en
utl7television.wikia.com	Community Central	en
utopist.wikia.com	Utopist Wiki	en
vaali.wikia.com	Vaaliwiki	fi
valenciclopedia.wikia.com	Valenciclopèdia	ca
valenthlibrary.wikia.com	The Valenth Public Library	en
valkyria.wikia.com	Valkyria Wiki	en
valkyriemovie.wikia.com	Valkyrie Movie Wiki	en
valkyrieprofile.wikia.com	Valkyrie Profile Wiki	en
valkyriesky.wikia.com	Valkyrie Sky Wiki	en
vampcat.wikia.com	VampCat Wiki	en
vampirediaries.wikia.com	The Vampire Diaries Wiki	en
vampirehunterd.wikia.com	Vampire Hunter D Wiki	en
vampireknight.wikia.com	Vampire Knight Wiki	en
vanguard.wikia.com	Vanguard Saga of Heroes	en
vcandrews.wikia.com	V.C. Andrews Wiki	en
vedmak.wikia.com	Ведьмак Вики	ru
vegan.wikia.com	The Case for a Vegan World	en
veggietales.wikia.com	VeggieTales Wiki	en
venetica.wikia.com	Venetica Wiki	en
vennixproductions.wikia.com	Vennix Productions	en
venturebrothers.wikia.com	Venture Brothers Wiki	en
vereadores.wikia.com	Adote um vereador	pt-br
vereins.wikia.com	VereinsWiki	de
veronicamars.wikia.com	Veronica Mars Wiki	en
verpackungslexikon.wikia.com	Verpackungslexikon	de
vertigo.wikia.com	Vertigo Comics Wiki	en
vexillium.wikia.com	Wikivex - The Free, Online, Vexillium Encyclopedia	en
vfk.wikia.com	The Virtual Family Kingdom Wiki	en
vgsales.wikia.com	Video Game Sales Wiki	en
vi.house.wikia.com	House MD Wiki	vi
vi.kingofchaos.wikia.com	Loạn Thế Chi Vương Wiki	vi
video-games.wikia.com	Video Game Wiki	en
videogameideas.wikia.com	Video Game Ideas Wiki	en
videojuego.wikia.com	Wikijuegos	es
vietnamwar.wikia.com	Vietnam War	en
villains.wikia.com	Villains Wiki	en
vim.wikia.com	Vim Tips Wiki	en
vintagepatterns.wikia.com	Vintage Sewing Patterns	en
virtualworlds.wikia.com	a wiki for virtual worlds	en
virus.wikia.com	VirusInfo	en
vistacity.wikia.com	Vista City Wiki	en
visualkei.wikia.com	Visual Kei Encyclopaedia	en
vocaloid.wikia.com	Vocaloid Wiki	en
volkswagens.wikia.com	Classic Volkswagen Technical Wiki	en
vollibre.wikia.com	Vol libre wiki	fr
voltron.wikia.com	Voltron Wiki	en
vongopedia.wikia.com	Vongopedia	pl
vorkosigan.wikia.com	Vorkosigan Wiki	en
vtes.wikia.com	Vampire: the Eternal Struggle Wiki	en
wackypedia.wikia.com	Wackypedia	en
wahwah.wikia.com	Wikiwahwah Guitar and Bass Effects Wiki	en
wakfu.wikia.com	Wakfu Wiki	en
wakfulesgardiens.wikia.com	Éliatropédie, un wiki sur Wakfu, Les Gardiens	fr
waldo.wikia.com	Waldo Wiki	en
walkingdead.wikia.com	Walking Dead Wiki	en
walkingwith.wikia.com	Walking With Wikis	en
wallaceandgromit.wikia.com	Wallace and Gromit Wiki	en
war.wikia.com	WarWiki	en
warbears.wikia.com	Warbears Wiki	en
warcraftfanon.wikia.com	Warcraft Fanon	en
warhammer40k.wikia.com	Warhammer 40k	en
warmetal.wikia.com	War Metal Wiki	en
waroflegends.wikia.com	War of Legends Wiki	en
warrior-cats.wikia.com	Warrior Cat Wiki	en
warriors.wikia.com	Warriors Wiki	en
warriorscharacters.wikia.com	Warriors Characters Wiki	en
warriorsfanfic.wikia.com	Warriors Fanfiction	en
warstorm.wikia.com	Warstorm Wiki	en
warszawa.wikia.com	Wszystko o Warszawie	pl
wasteland.wikia.com	Wasteland Wiki	en
watchmen.wikia.com	Watchmen Wiki	en
water.wikia.com	WaterWiki	en
wayfinder.wikia.com	Wikifinder	en
wayside.wikia.com	Wayside Wiki	en
wazoo.wikia.com	Wazoopedia	en
wbvdkt.wikia.com	WBVDKT Wiki	en
weapons.wikia.com	Weapon Wiki	en
weather.wikia.com	Weather Wiki	en
weatherchannel.wikia.com	The Weather Channel Wiki	en
webkinz.wikia.com	Webkinz Wikia	en
weddings.wikia.com	The everything Wedding Wiki	en
wednesday13.wikia.com	Wednesday 13 Wiki	en
weeblsstuff.wikia.com	Weebl's Stuff Wiki	en
weeds.wikia.com	Weeds Wiki	en
weigsbrag.wikia.com	Weigsbrag	de
weirdal.wikia.com	Weird Al Wiki	en
weissschwarz.wikia.com	Weiss Schwarz Wiki	en
weltenbibliothek.wikia.com	Weltenbibliothek	de
wesnoth.wikia.com	Wesnoth Wiki	en
westmarchsaga.wikia.com	Saga of Westmarch Wiki	en
westrology.wikia.com	Western Astrology Wiki	en
westward.wikia.com	The Westward Wiki	en
westwing.wikia.com	West Wing Wiki	en
whatreallyhappened.wikia.com	Community Central	en
whatshouldiread.wikia.com	A Very Literary Wiki	en
whentheycry.wikia.com	Higurashi no Naku Koro Ni Wiki	en
whiskey.wikia.com	Whiskeypedia Wiki	en
whitecollar.wikia.com	White Collar Wiki	en
whitehouse.wikia.com	Whitehouse Wiki	en
whitewolf.wikia.com	White Wolf	en
whysoserious.wikia.com	Arkhampedia	en
wiccana-aoc.wikia.com	Wiccana AoC Server Wiki	en
wicked.wikia.com	Wicked Wiki	en
wiedzmin.wikia.com	Wiedźmińska Wiki	pl
wielkabrytania.wikia.com	Wielka Brytania	pl
wielkapedia.wikia.com	Wielkapedia	pl
wiggles.wikia.com	Wigglepedia	en
wii.wikia.com	Wii Wiki	en
wiki-sentai.wikia.com	Super Sentai Wiki	en
wikieduca.wikia.com	WikiEduca	es
wikifrim.wikia.com	WikiFrIm	fr
wikingerwerkstatt.wikia.com	Community Central	en
wildarms.wikia.com	Wild Arms Wiki	en
wildcards.wikia.com	Wild Cards Wiki	en
wildlifeofalberta.wikia.com	Wildlife of Alberta Wiki	en
williamsstreet.wikia.com	Williams Street Wiki	en
wingcommander.wikia.com	Wing Commander Information Center	en
winx.wikia.com	Winx Club Wiki	en
wipeout.wikia.com	Wipeout Central	en
witch.wikia.com	W.I.T.C.H. Wiki	en
witcher.wikia.com	Witcher Wiki	en
wizard101.wikia.com	Wizard 101 Wiki	en
wizardofoz.wikia.com	Oz Wiki	en
wizardsofwaverlyplace.wikia.com	Wizards of Waverly Place Wiki	en
wochenende.wikia.com	Wochenendwiki	de
wolfbrother.wikia.com	Chronicles of Ancient Darkness Wiki	en
wolfenstein.wikia.com	Wolfenstein Wiki	en
wolsung.wikia.com	Encyclopaedia Alfheimica	pl
wonder-woman.wikia.com	The Wonder Woman Wiki	en
wonderlandonline.wikia.com	Wonderland Online Wiki	en
wonderpets.wikia.com	Wonder Pets! Wiki	en
woot.wikia.com	Woot Wiki	en
wordgirl.wikia.com	WordGirl Wiki	en
worldinconflict.wikia.com	WICapedia	en
worldofcars.wikia.com	World of Cars Online Wiki	en
worldofdarkness.wikia.com	Wod	en
worldofgoo.wikia.com	World of Goo Wiki	en
worldofkungfu.wikia.com	World of Kung Fu Wiki	en
worlduniversity.wikia.com	World University	en
wot.wikia.com	A Wheel of Time Wiki	en
wowrp.wikia.com	World of Warcraft Roleplay	en
wpi.wikia.com	WPI Wiki	en
writers.wikia.com	Writers of the World	en
wroclaw.wikia.com	WikiWrocław	pl
wrongdirection.wikia.com	Community Central	en
wubbzy.wikia.com	Wubbzypedia	en
wwebrady.wikia.com	WWE Wiki	en
www.serioussam.wikia.com	Serious Sam Wiki	en
www.whiteknightchronicles.wikia.com	White Knight Chronicles Wiki	en
wyrmrest.wikia.com	Wyrmrest Accord Wiki	en
x.wikia.com	Xuniverse	en
x-files.wikia.com	X-Files Wiki	en
x-men.wikia.com	X-Men Wiki	en
xanth.wikia.com	Xanth	en
xbox.wikia.com	Xbox Wiki	en
xcsoar.wikia.com	Xcsoar Wiki	en
xeen.wikia.com	Xeen Wiki	en
xenosaga.wikia.com	Xenosaga Wiki	en
xmenmovies.wikia.com	X-Men Movies Wiki	en
xtc.wikia.com	XTC Wiki	en
xxxholic.wikia.com	Holic Wiki	en
yaruo.wikia.com	やる夫 Wiki	ja
ycm.wikia.com	Yu-Gi-Oh Card Maker Wiki	en
yes.wikia.com	Yes	en
yggdraunion.wikia.com	Dept. Heaven Wiki	en
ygofanfic.wikia.com	Yu-Gi-Oh! Fanfiction	en
yinyangyo.wikia.com	Yin Yang Yo! Wiki	en
yoshi.wikia.com	Yoshi Wiki	en
youkai.wikia.com	妖怪煉成陣	zh-tw
youngdracula.wikia.com	Young Dracula Wiki	en
youtube.wikia.com	Wikitubia	en
yoville.wikia.com	YoWorld Wiki	en
yugioh.wikia.com	Yu-Gi-Oh!	en
yugioh-x13.wikia.com	Yu-Gi-Oh! X13 Wiki	en
yugiohboardgame.wikia.com	Yu-Gi-Oh! Board Game Wiki	en
yugiohthree.wikia.com	Yu-Gi-Oh! 3 Wiki	en
yukkuri.wikia.com	Yukkuri Wiki	en
yutongo.wikia.com	Yutongo Wiki	en
yuyuhakusho.wikia.com	YuYu Hakusho Wiki	en
zaklinac.wikia.com	Zaklínač Wiki	cs
zapedia.wikia.com	Zapytaj Wiki	pl
zapytaj.wikia.com	WikiZapytaj	pl
zegafighters.wikia.com	Davon and Friends Wiki	en
zelda.wikia.com	Zeldapedia	en
zeldafanon.wikia.com	Zelda Fanon Wiki	en
zeldumb.wikia.com	Zeldumb Wiki	en
zeropunctuation.wikia.com	Zero Punctuation Wiki	en
zezenia.wikia.com	Zezenia Wiki	en
zh-cn.libraries.wikia.com	图情档学科信息门户	zh-cn
zh-hk.chinesechess.wikia.com	Chinesechess Wiki	zh-hk
zh-hk.hongkong.wikia.com	香港民風大典	zh-hk
zh-hk.taiko.wikia.com	太鼓之達人維基	zh
zh-tw.doraemon.wikia.com	哆啦A夢wiki	zh
zh-tw.med.wikia.com	醫學快紀	zh-tw
zh-tw.pharmacy.wikia.com	藥學共筆	zh-tw
zh-tw.runescape.wikia.com	RuneScape維基	zh-tw
zh-tw.warhammeronline.wikia.com	Warhammer Online Wiki	zh-tw
zh-tw.wow.wikia.com	魔獸世界百科全書	zh-tw
zh.8thworld.wikia.com	The 8th World related and others Wiki	zh
zh.Wordpress.wikia.com	Wordpress 中文	zh
zh.answers.wikia.com	QNA 维基	zh
zh.archery.wikia.com	箭術之書	zh
zh.aromatherapy.wikia.com	探索芳療wikia	zh-tw
zh.biblestudy.wikia.com	中文基督教大典	zh
zh.college.wikia.com	College	zh
zh.football.wikia.com	Wikia足球俱樂部	zh
zh.lostpedia.wikia.com	Lostpedia	zh
zh.macauie.wikia.com	馬交網際百科 Wiki	zh
zh.neopets.wikia.com	Neopets's Encyclopedia!!!	zh-hk
zh.onepiece.wikia.com	航海王wiki	zh
zh.palmardrama.wikia.com	布袋戲資料庫	zh-tw
zh.prowrestling.wikia.com	Pro Wrestling Wikia 中文職摔大百科	zh
zh.restaurants.wikia.com	Restaurants	zh
zh.scratchpad.wikia.com	圍紀實驗室	zh
zh.superstar.wikia.com	SuperStar	zh
zh.tv.wikia.com	中文電視大典	zh-tw
zh.wikiteamwork.wikia.com	WikiTeamWork	zh-tw
zh.wonnit.wikia.com	文野網站wiki	zh
zh.yinhun.wikia.com	银魂 Wiki	zh
zim.wikia.com	Invader ZIM Wiki	en
zivilizacio.wikia.com	Zivilizacio	de
zoey101.wikia.com	Zoey 101 Wiki	en
zombie.wikia.com	Zombiepedia	en
zomg.wikia.com	zOMG Wiki	en
zoology.wikia.com	Animal Database	en
zootycoon.wikia.com	Zoo Tycoon Wiki	en
zork.wikia.com	Zork Wiki	en
zuda.wikia.com	Zuda Database Wiki	en
zumalifeguard.wikia.com	Zuma Lifeguard Wiki	en
